name	parent	synonyms
Ectoprocta	Animalia	syn1|syn2|syn3
Gymnolaemata	Ectoprocta	syn4|syn5
Ctenostomata	Gymnolaemata	syn6
Carnosa	Ctenostomata	syn7
Alcyonidiidae	Carnosa
Alcyonidium	Alcyonidiidae
polyoum	Alcyonidium
mamillatum	Alcyonidium
mamillatum	mamillatum
erectum	mamillatum
pedunculatum	Alcyonidium
disciforme	Alcyonidium
enteromorpha	Alcyonidium
parasiticum	Alcyonidium
verrilli	Alcyonidium
mytili	Alcyonidium
vermiculare	Alcyonidium
gelatinosum	Alcyonidium
gelatinosum	gelatinosum
diaphanum	gelatinosum
anderssoni	gelatinosum
pachydermatum	gelatinosum
albidum	Alcyonidium
polypylum	Alcyonidium
hirsutum	Alcyonidium
proboscideum	Alcyonidium
radicellatum	Alcyonidium
excavatum	Alcyonidium
irregulare	Alcyonidium
Flustrellidridae	Carnosa
Flustrellidra	Flustrellidridae
hispida	Flustrellidra
corniculata	Flustrellidra
cervicornis	Flustrellidra
vegae	Flustrellidra
Claviporidae	Carnosa
Clavipora	Claviporidae
occidentalis	Clavipora
Pseudalcyonidium	Claviporidae
bobinae	Pseudalcyonidium
Pherusellidae	Carnosa
Paludicelloidea	Carnosa
Victorellidae	Paludicelloidea
Victorella	Victorellidae
pavida	Victorella
Sundanella	Victorellidae
sibogae	Sundanella
Arachnidiidae	Paludicelloidea
Arachnidium	Arachnidiidae
clavatum	Arachnidium
hippothoides	Arachnidium
simplex	Arachnidium
Arachnoidea	Arachnidiidae
barentsia	Arachnoidea
Nolellidae	Paludicelloidea
Nolella	Nolellidae
stipata	Nolella
dilatata	Nolella
Anguinella	Nolellidae
palmata	Anguinella
Paludicellidae	Paludicelloidea
Paludicella	Paludicellidae
articella	Paludicella
articulata	Paludicella
Pottsiella	Paludicellidae
erecta	Pottsiella
Vesicularioidea	Carnosa
Vesiculariidae	Vesicularioidea
Amathia	Vesiculariidae
convoluta	Amathia
vidovici	Amathia
alternata	Amathia
distans	Amathia
lendigera	Amathia
Bowerbankia	Vesiculariidae
gracilis	Bowerbankia
aggregata	gracilis
gracilis	gracilis
imbricata	Bowerbankia
maxima	Bowerbankia
pustulosa	Bowerbankia
arctica	Bowerbankia
caudata	Bowerbankia
composita	Bowerbankia
Vesicularia	Vesiculariidae
fasciculata	Vesicularia
Farrella	Vesiculariidae
gigantea	Farrella
repens	Farrella
Zoobotryon	Vesiculariidae
verticillatum	Zoobotryon
Stolonifera	Ctenostomata
Walkeriidae	Stolonifera
Aeverrillia	Walkeriidae
armata	Aeverrillia
setigera	Aeverrillia
Mimosellidae	Stolonifera
Buskiidae	Stolonifera
Buskia	Buskiidae
australis	Buskia
nitens	Buskia
Triticellidae	Stolonifera
Triticella	Triticellidae
elongata	Triticella
pedicellata	Triticella
flava	Triticella
Valkeriidae	Stolonifera
Valkeria	Valkeriidae
atlantica	Valkeria
uva	Valkeria
Terebriporina	Ctenostomata
Terebriporidae	Terebriporina
Penetrantiidae	Terebriporina
Immergentiidae	Terebriporina
Cyclostomata	Gymnolaemata
Articulata	Cyclostomata
Crisiidae	Articulata
Crisia	Crisiidae
eburnea	Crisia
cribraria	Crisia
occidentalis	Crisia
denticulata	Crisia
denticulata	denticulata
borgi	denticulata
arctica	denticulata
elongata	Crisia
aculeata	Crisia
aculeata	aculeata
bathyalis	aculeata
eburneo-denticulata	Crisia
constans	Crisia
Bicrisia	Crisiidae
edwardsiana	Bicrisia
abyssicola	Bicrisia
Filicrisia	Crisiidae
franciscana	Filicrisia
geniculata	Filicrisia
smitti	Filicrisia
Crisidia	Crisiidae
cornuta	Crisidia
orientalis	Crisidia
Crisulipora	Crisiidae
orientalis	Crisulipora
occidentalis	Crisulipora
Crisiella	Crisiidae
producta	Crisiella
diversa	Crisiella
complecta	Crisiella
Tubuliporina	Cyclostomata
Diastoporidae	Tubuliporina
Diplosolen	Diastoporidae
obelia	Diplosolen
obelia	obelia
arctica	obelia
intricarius	Diplosolen
Berenicea	Diastoporidae
arctica	Berenicea
oblonga	Berenicea
patina	Berenicea
meandrina	Berenicea
Tubuliporidae	Tubuliporina
Tubulipora	Tubuliporidae
flabellaris	Tubulipora
atlantica	Tubulipora
liliacea	Tubulipora
lobulata	Tubulipora
transversa	Tubulipora
maris-albi	Tubulipora
eminens	Tubulipora
dilatans	Tubulipora
fructuosa	Tubulipora
smitti	Tubulipora
uniformis	Tubulipora
aperta	Tubulipora
minuta	Tubulipora
borgi	Tubulipora
murmanica	Tubulipora
ventricosa	Tubulipora
soluta	Tubulipora
penicillata	Tubulipora
nordgaardi	Tubulipora
fruticosa	Tubulipora
Bathysoecia	Tubuliporidae
bassleri	Bathysoecia
hastingsae	Bathysoecia
Idmonea	Tubuliporidae
atlantica	Idmonea
atlantica	atlantica
gracilima	atlantica
fenestrata	Idmonea
tumida	Idmonea
bidenkapi	Idmonea
Idmidronea	Tubuliporidae
atlantica	Idmidronea
Stomatopora	Tubuliporidae
granulata	Stomatopora
Idmoneoides	Tubuliporidae
arctoflabellaris	Idmoneoides
simplex	Idmoneoides
Oncousoeciidae	Tubuliporina
Oncousoecia	Oncousoeciidae
canadensis	Oncousoecia
diastroporides	Oncousoecia
polygonales	Oncousoecia
Proboscina	Oncousoeciidae
incrassata	Proboscina
gracilis	Proboscina
fecunda	Proboscina
major	Proboscina
boryi	Proboscina
Terviidae	Tubuliporina
Entalophoridae	Tubuliporina
Entalophora	Entalophoridae
capitata	Entalophora
proboscideoides	Entalophora
cellarioides	Entalophora
clavata	Entalophora
harmeri	Entalophora
Bientalophora	Entalophoridae
cylindrica	Bientalophora
Diaperoeciidae	Tubuliporina
Diaperoecia	Diaperoeciidae
johnstoni	Diaperoecia
intermedia	Diaperoecia
floridana	Diaperoecia
harmeri	Diaperoecia
californica	Diaperoecia
Plagioeciidae	Tubuliporina
Plagioecia	Plagioeciidae
ambigua	Plagioecia
grimaldii	Plagioecia
patina	Plagioecia
dispar	Plagioecia
Hastingsiidae	Tubuliporina
Frondiporidae	Tubuliporina
Filifascigera	Frondiporidae
fasciculata	Filifascigera
Fasciculiporoides	Frondiporidae
americana	Fasciculiporoides
Theonoidae	Tubuliporina
Mecynoeciidae	Tubuliporina
Cancellata	Cyclostomata
Horneridae	Cancellata
Cytididae	Cancellata
Petaloporidae	Cancellata
Pseudidmoneidae	Cancellata
Calvetiidae	Cancellata
Stigmatoechidae	Cancellata
Stigmatoechos	Stigmatoechidae
violacea	Stigmatoechos
arctica	Stigmatoechos
Hornera	Stigmatoechidae
frondiculata	Hornera
violacea	Hornera
Cerioporina	Cyclostomata
Heteroporidae	Cerioporina
Heteropora	Heteroporidae
alaskensis	Heteropora
pacifica	Heteropora
magna	Heteropora
pelliculata	Heteropora
Borgiola	Heteroporidae
pustulosa	Borgiola
Borgella	Heteroporidae
tumulosa	Borgella
Corymboporidae	Cerioporina
Domopora	Corymboporidae
stellata	Domopora
diadema	Domopora
Defrancia	Corymboporidae
clypeata	Defrancia
lucernaria	Defrancia
lucernaria	lucernaria
prolifera	lucernaria
Tretocycloeciidae	Cerioporina
Rectangulata	Cyclostomata
Lichenoporidae	Rectangulata
Lichenopora	Lichenoporidae
canaliculata	Lichenopora
verrucaria	Lichenopora
hispida	Lichenopora
radiata	Lichenopora
turbinata	Lichenopora
multicentra	Lichenopora
sibirica	Lichenopora
crassiuscula	Lichenopora
Disporella	Lichenoporidae
alaskensis	Disporella
umbellata	Disporella
depressa	umbellata
umbellata	umbellata
Fungella	Lichenoporidae
dujardini	Fungella
dalli	Fungella
Cheilostomata	Gymnolaemata
Anasca	Cheilostomata
Aeteidae	Anasca
Aetea	Aeteidae
anguina	Aetea
truncata	Aetea
sica	Aetea
recta	Aetea
Scrupariidae	Anasca
Eucratea	Scrupariidae
loricata	Eucratea
loricata	loricata
arctica	loricata
cornuta	loricata
macrostoma	loricata
Haplota	Scrupariidae
clavata	Haplota
Scruparia	Scrupariidae
ambigua	Scruparia
chelata	Scruparia
Labiostomellidae	Anasca
Membraniporidae	Anasca
Membranipora	Membraniporidae
membranacea	Membranipora
pachytheca	Membranipora
tenuis	Membranipora
tuberculata	Membranipora
monostachys	Membranipora
aborescens	Membranipora
savartii	Membranipora
tenella	Membranipora
villosa	Membranipora
Conopeum	Membraniporidae
reticulum	Conopeum
truitti	Conopeum
seurati	Conopeum
tenuissimum	Conopeum
Desmacystis	Membraniporidae
sandalia	Desmacystis
Cupuladria	Membraniporidae
canariensis	Cupuladria
doma	Cupuladria
biporosa	Cupuladria
Ramphonotus	Membraniporidae
minax	Ramphonotus
gorbunovi	Ramphonotus
Larnacicus	Membraniporidae
corniger	Larnacicus
Megapora	Membraniporidae
ringens	Megapora
Reussina	Membraniporidae
impressa	Reussina
Electridae	Anasca
Electra	Electridae
crustulenta	Electra
arctica	crustulenta
baltica	crustulenta
catenularia-similis	crustulenta
crustulenta	crustulenta
hastingsae	Electra
pilosa	Electra
pilosa	pilosa
dentata	pilosa
bellula	Electra
laciniosa	Electra
arctica	Electra
verticillata	Electra
catenularia	Electra
Pyripora	Electridae
catenularia	Pyripora
Flustridae	Anasca
Flustra	Flustridae
carbasea	Flustra
serrulata	Flustra
foliacea	Flustra
nordenskjoldi	Flustra
barleei	Flustra
securifrons	Flustra
Terminoflustra	Flustridae
membranaceo-truncata	Terminoflustra
Securiflustra	Flustridae
securifrons	Securiflustra
Sarsiflustra	Flustridae
abyssicola	Sarsiflustra
Hincksinidae	Anasca
Hincksina	Hincksinidae
gothica	Hincksina
Cauloramphus	Hincksinidae
cymbaeformis	Cauloramphus
echinus	Cauloramphus
spiniferum	Cauloramphus
intermedius	Cauloramphus
Aplousina	Hincksinidae
gigantea	Aplousina
Antropora	Hincksinidae
tincta	Antropora
leucocypha	Antropora
Calloporidae	Anasca
Callopora	Calloporidae
aurita	Callopora
craticula	Callopora
craticula	craticula
sedovi	craticula
exilis	Callopora
lineata	Callopora
whiteavesi	Callopora
horrida	Callopora
dumerilii	Callopora
smitti	Callopora
lata	Callopora
obesa	Callopora
derjugini	Callopora
circumclathrata	Callopora
Amphiblestrum	Calloporidae
trifolium	Amphiblestrum
trifolium	trifolium
guadrata	trifolium
flemingi	Amphiblestrum
osburni	Amphiblestrum
septentrionalis	Amphiblestrum
Bidenkapia	Calloporidae
spitsbergensis	Bidenkapia
alaskensis	spitsbergensis
spitsbergensis	spitsbergensis
Doryporella	Calloporidae
spathulifera	Doryporella
Tegella	Calloporidae
armifera	Tegella
arctica	Tegella
arctica	arctica
retroversa	arctica
unicornis	Tegella
magnipora	Tegella
robertsonae	Tegella
aquilirostris	Tegella
armiferoides	Tegella
kildinensis	Tegella
spitzbergensis	Tegella
nigrans	Tegella
anguloavicularis	Tegella
inermis	Tegella
amissavicularis	Tegella
norvegica	Tegella
Alderina	Calloporidae
smitti	Alderina
imbellis	Alderina
Copidozoum	Calloporidae
tenuirostre	Copidozoum
Parellisina	Calloporidae
curvirostris	Parellisina
latirostris	Parellisina
Crassimarginatella	Calloporidae
tuberosa	Crassimarginatella
Retevirgula	Calloporidae
acuta	Retevirgula
Chaperiidae	Anasca
Chaperia	Chaperiidae
acanthina	Chaperia
quadrispinosa	Chaperia
cervicornis	Chaperia
spinosissima	Chaperia
galeata	Chaperia
Hiantoporidae	Anasca
Arachnopusiidae	Anasca
Exechonella	Exechonellidae
antillea	Exechonella
Tremogasterina	Arachnopusiidae
lanceotata	Tremogasterina
muronata	Tremogasterina
Onychocellidae	Anasca
Floridina	Onychocellidae
antique	Floridina
parvicella	Floridina
Smittipora	Onychocellidae
levinseni	Smittipora
abyssicola	Smittipora
solida	Smittipora
Microporidae	Anasca
Micropora	Microporidae
coriacea	Micropora
Mollia	Microporidae
potellaria	Mollia
Selenaria	Microporidae
maculata	Selenaria
Lunulitidae	Anasca
Calpensiidae	Anasca
Microporina	Calpensiidae
borealis	Microporina
articulata	Microporina
Discoporella	Calpensiidae
umbellata	Discoporella
Steginoporellidae	Anasca
Steginoporella	Steginoporellidae
magnilabris	Steginoporella
Labiporella	Steginoporellidae
granulosa	Labiporella
Thalamoporellidae	Anasca
Thalamoporella	Thalamoporellidae
falcifer	Thalamoporella
california	Thalamoporella
Aspidostomatidae	Anasca
Euritina	Aspidostomatidae
arctica	Euritina
Setosellidae	Anasca
Cothurnicellidae	Anasca
Alysidiidae	Anasca
Cellariidae	Anasca
Cellaria	Cellariidae
nodosa	Cellaria
fistulosa	Cellaria
sinuosa	Cellaria
diffusa	Cellaria
Euginoma	Cellariidae
cavalieri	Euginoma
duplex	Euginoma
Formosocellaria	Cellariidae
abyssicola	Formosocellaria
magnifica	Formosocellaria
Pseudocellaria	Cellariidae
Membranicellariidae	Anasca
Farciminariidae	Anasca
Nellia	Farciminariidae
tenella	Nellia
oculata	Nellia
Bugulidae	Anasca
Bugula	Bugulidae
turrita	Bugula
flabellata	Bugula
acuminata	flabellata
flabellata	flabellata
pacifica	Bugula
avicularia	Bugula
neritina	Bugula
rylandi	Bugula
fulva	Bugula
grayi	Bugula
marcusi	Bugula
microoecia	Bugula
plumosa	Bugula
stolonifera	Bugula
turbinata	Bugula
johnstonae	Bugula
longirostrata	Bugula
harmsworthi	Bugula
tricuspis	Bugula
fastigata	Bugula
tschukotkensis	Bugula
elongata	Bugula
calathus	Bugula
Dendrobeania	Bugulidae
murrayana	Dendrobeania
multiseriata	Dendrobeania
lichenoides	Dendrobeania
curvirostrata	Dendrobeania
pseudolevinseni	Dendrobeania
levinseni	Dendrobeania
laxa	Dendrobeania
pseudomurrayana	Dendrobeania
pseudomurrayana	pseudomurrayana
tenuis	pseudomurrayana
fessa	pseudomurrayana
fruticosa	Dendrobeania
fruticosa	fruticosa
quadridentata	fruticosa
frigida	fruticosa
flustroides	Dendrobeania
murmanica	Dendrobeania
Caulibugula	Bugulidae
dendrograpta	Caulibugula
pearsei	Caulibugula
californica	Caulibugula
Kinetoskias	Bugulidae
arborescens	Kinetoskias
smitti	Kinetoskias
mitsukurii	Kinetoskias
beringi	Kinetoskias
Bicellariellidae	Anasca
Corynoporella	Bicellariellidae
spinosa	Corynoporella
tenuis	Corynoporella
Bicellariella	Bicellariellidae
ciliata	Bicellariella
Bicellarina	Bicellariellidae
alderi	Bicellarina
Semibugula	Bicellariellidae
birulai	Semibugula
Beaniidae	Anasca
Beania	Beaniidae
alaskensis	Beania
Scrupocellariidae	Anasca
Scrupocellaria	Scrupocellariidae
scabra	Scrupocellaria
paenulata	scabra
scabra	scabra
bertholetti	Scrupocellaria
regularis	Scrupocellaria
scruposa	Scrupocellaria
scrupea	Scrupocellaria
diegensis	Scrupocellaria
californica	Scrupocellaria
intermedia	Scrupocellaria
minor	Scrupocellaria
arctica	Scrupocellaria
Caberea	Scrupocellariidae
ellisii	Caberea
boryi	Caberea
Tricellaria	Scrupocellariidae
ternata	Tricellaria
gracilis	Tricellaria
gracilis	gracilis
inermis	gracilis
pribilofi	Tricellaria
erecta	Tricellaria
occidentalis	Tricellaria
peachii	Tricellaria
praescuta	Tricellaria
Notoplites	Scrupocellariidae
rostrata	Notoplites
jeffreysii	Notoplites
sibirica	Notoplites
smitti	Notoplites
normani	Notoplites
Bugulopsis	Scrupocellariidae
peachi	Bugulopsis
peachi	peachi
beringia	peachi
Epistomiidae	Anasca
Synnotum	Epistomiidae
aegyptiacum	Synnotum
Cribrilinidae	Anasca
Cribrilina	Cribrilinidae
annulata	Cribrilina
punctata	Cribrilina
radiata	Cribrilina
spitzbergensis	Cribrilina
cryptooecium	Cribrilina
watersi	Cribrilina
spiculifera	Cribrilina
Membraniporella	Cribrilinidae
crassicosta	Membraniporella
aragoi	Membraniporella
nitida	Membraniporella
Reginella	Cribrilinidae
spitsbergensis	Reginella
Jullienula	Cribrilinidae
hippocrepis	Jullienula
Bellulopora	Cribrilinidae
bellula	Bellulopora
Colletosia	Cribrilinidae
radiata	Colletosia
Lyrula	Cribrilinidae
hippocrepis	Lyrula
Gephyrotes	Cribrilinidae
nitidopunctata	Gephyrotes
Pelmatoporidae	Anasca
Cupuladriidae	Anasca
Sadkoidae	Anasca
Uschakovia	Sadkoidae
gorbunovi	Uschakovia
Ascophora	Cheilostomata
Cyclicoporidae	Ascophora
Hippothoidae	Ascophora
Hippothoa	Hippothoidae
hyalina	Hippothoa
abstersa	hyalina
marcusi	hyalina
hyalina	hyalina
divaricata	Hippothoa
divaricata	divaricata
arctica	divaricata
expansa	Hippothoa
cornuta	Hippothoa
flagellum	Hippothoa
santacruzana	Hippothoa
planula	Hippothoa
rugulosa	Hippothoa
discreta	Hippothoa
annularis	Hippothoa
patagonica	Hippothoa
muricata	Hippothoa
holostoma	Hippothoa
tuberculata	Hippothoa
meridionalis	Hippothoa
distans	Hippothoa
minitumulosa	Hippothoa
brasiliensis	Hippothoa
trigemma	Hippothoa
Harmeria	Hippothoidae
scutulata	Harmeria
Hincksipora	Hippothoidae
spinulifera	Hincksipora
Trypostega	Hippothoidae
venusta	Trypostega
Haplopoma	Hippothoidae
impressum	Haplopoma
Chorizopora	Hippothoidae
brongniartii	Chorizopora
Dacryoporella	Hippothoidae
gutta	Dacryoporella
Diplotresis	Hippothoidae
sparsiporsa	Diplotresis
Atacama	Hippothoidae
foramina	Atacama
Boreas	Hippothoidae
voigti	Boreas
Kronothoa	Hippothoidae
dissoluta	Kronothoa
Tecatia	Hippothoidae
minuta	Tecatia
sinaloenis	Tecatia
Euthyroididae	Ascophora
Umbonulidae	Ascophora
Umbonula	Umbonulidae
patens	Umbonula
arctica	Umbonula
littoralis	Umbonula
verrucosa	Umbonula
inarmata	Umbonula
Petraliidae	Ascophora
Petraliella	Petraliellidae
bisinuata	Petraliella
marginata	Petraliella
Gigantoporidae	Ascophora
Cylindroporella	Gigantoporidae
tubulosa	Cylindroporella
Tessaradoma	Tessaradomidae
gracile	Tessaradoma
Stomachetosellidae	Ascophora
Stomachetosella	Stomachetosellidae
sinuosa	Stomachetosella
cruenta	Stomachetosella
distincta	Stomachetosella
hincksi	Stomachetosella
producta	Stomachetosella
collaris	Stomachetosella
Posterula	Stomachetosellidae
sarsi	Posterula
Ragionula	Stomachetosellidae
rosacea	Ragionula
Pachyegis	Stomachetosellidae
princeps	Pachyegis
brunnea	Pachyegis
Cigclisula	Stomachetosellidae
serrulata	Cigclisula
turrita	Cigclisula
pertusa	Cigclisula
Schizoporellidae	Ascophora
Schizoporella	Schizoporellidae
unicornis	Schizoporella
linearis	Schizoporella
inarmata	linearis
linearis	linearis
cornuta	Schizoporella
biaperta	Schizoporella
errata	Schizoporella
floridana	Schizoporella
crustacea	Schizoporella
costata	Schizoporella
bispinosus	Schizoporella
elmwoodiae	Schizoporella
elmwoodiae	elmwoodiae
mamillata	elmwoodiae
alderi	Schizoporella
auriculata	Schizoporella
auriculata	auriculata
lineata	auriculata
porifera	Schizoporella
ortmanni	Schizoporella
magniporata	Schizoporella
pachystega	Schizoporella
incerta	Schizoporella
limbata	Schizoporella
stylifera	Schizoporella
stylifera	stylifera
perforata	stylifera
hexagona	Schizoporella
smitti	Schizoporella
thompsoni	Schizoporella
Emballotheca	Schizoporellidae
stylifera	Emballotheca
Dakaria	Schizoporellidae
dawsoni	Dakaria
Schizomavella	Schizoporellidae
auriculata	Schizomavella
ochracea	auriculata
auriculata	auriculata
porifera	Schizomavella
linearis	Schizomavella
Hippodiplosia	Schizoporellidae
reticulatopunctata	Hippodiplosia
insculpta	Hippodiplosia
cancellata	Hippodiplosia
pertusa	Hippodiplosia
propinqua	Hippodiplosia
murdochi	Hippodiplosia
obesa	Hippodiplosia
tchukotkensis	Hippodiplosia
borealis	Hippodiplosia
harmsworthi	Hippodiplosia
ussowi	Hippodiplosia
Arthropoma	Schizoporellidae
cecilii	Arthropoma
Cleidochasma	Cleidochasmatidae
porcellanum	Cleidochasma
contractum	Cleidochasma
Cycloporiella	Schizoporellidae
rubra	Cycloporiella
Stylopoma	Schizoporellidae
informata	Stylopoma
spongites	Stylopoma
Escharina	Schizoporellidae
porosa	Escharina
vulgaris	Escharina
pesanseris	Escharina
Hippoporinidae	Ascophora
Hippoporella	Hippoporinidae
hippopus	Hippoporella
ulvlifera	Hippoporella
Stephanosella	Hippoporinidae
biaperta	Stephanosella
Lepralia	Hippoporinidae
americana	Lepralia
serrata	Lepralia
pallisiana	Lepralia
Hippopleurifera	Hippoporinidae
mucronata	Hippopleurifera
Hippoporina	Hippoporinidae
contracta	Hippoporina
verrilli	Hippoporina
americana	Hippoporina
Hippoporidra	Hippoporinidae
calcarea	Hippoporidra
edax	Hippoporidra
janthina	Hippoporidra
Hipporina	Hippoporinidae
Pentapora	Hippoporinidae
foliacea	Pentapora
Exochellidae	Ascophora
Escharoides	Exochellidae
jacksoni	Escharoides
jacksoni	jacksoni
rostrata	jacksoni
coccinea	Escharoides
bidenkapi	Escharoides
monstruosa	Escharoides
Exochella	Exochellidae
longirostris	Exochella
Microporellidae	Ascophora
Microporella	Microporellidae
ciliata	Microporella
stellata	ciliata
ciliata	ciliata
arctica	Microporella
vibraculifera	Microporella
cribosa	Microporella
californica	Microporella
marsupiata	Microporella
umbraeula	Microporella
impressa	Microporella
malusii	Microporella
Fenestrulina	Microporellidae
malusii	Fenestrulina
umbonata	malusii
malusii	malusii
Eurystomellidae	Ascophora
Eurystomella	Eurystomellidae
bilabiata	Eurystomella
Mucronellidae	Ascophora
Porella	Mucronellidae
reduplicata	Porella
compressa	Porella
acutirostris	Porella
porifera	Porella
patens	Porella
sacata	Porella
sacata	sacata
beringia	sacata
minuta	Porella
smitti	Porella
struma	Porella
aperta	Porella
tumida	Porella
groenlandica	Porella
princeps	Porella
proboscidea	Porella
plana	Porella
laevis	Porella
Smittina	Mucronellidae
landsborovii	Smittina
arctica	Smittina
retifrons	Smittina
bella	Smittina
altirostris	Smittina
smittiella	Smittina
majuscula	Smittina
rigida	Smittina
reticulata	Smittina
minuscula	Smittina
peristomata	Smittina
glaciata	Smittina
mucronata	Smittina
concinna	Smittina
concinna	concinna
belli	concinna
pseudoacutirostris	Smittina
muliebris	Smittina
smitti	Smittina
tuberosa	Smittina
beringia	Smittina
trispinosa	Smittina
jeddreysi	Smittina
thompsoni	Smittina
Parasmittina	Mucronellidae
trispinosa	Parasmittina
jeffreysi	Parasmittina
alaskensis	Parasmittina
nitida	Parasmittina
spathulata	Parasmittina
crosslandi	Parasmittina
Rhamphostomella	Mucronellidae
costata	Rhamphostomella
costata	costata
cristata	costata
fortissima	Rhamphostomella
bilaminata	Rhamphostomella
bilaminata	bilaminata
sibirica	bilaminata
hincksi	Rhamphostomella
spinigera	Rhamphostomella
ovata	Rhamphostomella
gigantea	Rhamphostomella
radiatula	Rhamphostomella
scabra	Rhamphostomella
plicata	Rhamphostomella
Cystisella	Mucronellidae
saccata	Cystisella
bicornis	Cystisella
Hemicyclopora	Mucronellidae
polita	Hemicyclopora
emucronata	Hemicyclopora
Escharopsis	Mucronellidae
sarsi	Escharopsis
rosacea	Escharopsis
Tubucellariidae	Ascophora
Reteporidae	Ascophora
Lepraliella	Reteporidae
contigua	Lepraliella
Rhynchozoon	Reteporidae
bispinosum	Rhynchozoon
rostratum	Rhynchozoon
tuberculatum	Rhynchozoon
spicatum	Rhynchozoon
Phidolopora	Reteporidae
pacifica	Phidolopora
Schizotheca	Reteporidae
fissa	Schizotheca
Sertella	Reteporidae
beaniana	Sertella
marsupiata	Sertella
Reteporellina	Reteporidae
evelinae	Reteporellina
Retepora	Reteporidae
cellulosa	Retepora
reticulata	Retepora
elongata	Retepora
beaniana	Retepora
beaniana	beaniana
watersi	beaniana
Adeonidae	Ascophora
Bracebridgia	Adeonidae
subsulcata	Bracebridgia
Reptadeonella	Adeonidae
violacea	Reptadeonella
Adeonellopsis	Adeonidae
tuberculata	Adeonellopsis
lichenoides	Adeonellopsis
Cheiloporinidae	Ascophora
Cryptosula	Cryptosulidae
pallasiana	Cryptosula
Hippaliosina	Cheiloporinidae
rostrigera	Hippaliosina
Tetraplaria	Cheiloporinidae
dichotoma	Tetraplaria
Parmulariidae	Ascophora
Phylactelliporidae	Ascophora
Lagenipora	Celleporidae
spinulosa	Lagenipora
socialis	Lagenipora
Crepidacanthidae	Ascophora
Crepidacantha	Crepidacanthidae
setigera	Crepidacantha
poissoni	Crepidacantha
teres	poissoni
poissoni	poissoni
Celleporidae	Ascophora
Costazia	Celleporidae
nordenskjoldi	Costazia
surcularis	Costazia
ventricosa	Costazia
robertsoniae	Costazia
procumbens	Costazia
ignota	Costazia
Omalosecosa	Celleporidae
ramulosa	Omalosecosa
Turbicellepora	Celleporidae
dichotoma	Turbicellepora
canaliculata	Turbicellepora
Celleporina	Celleporidae
hassallii	Celleporina
Trematoecia	Celleporidae
turrita	Trematoecia
Buskea	Celleporidae
dichotoma	Buskea
Cellepora	Celleporidae
nordenskjoldi	Cellepora
surcularis	Cellepora
ventricosa	Cellepora
smitti	Cellepora
nodulosa	Cellepora
pumicosa	Cellepora
canaliculata	Cellepora
avicularis	Cellepora
ramulosa	Cellepora
Pasytheidae	Ascophora
Catenicellidae	Ascophora
Savignyellidae	Ascophora
Savignyella	Savignyellidae
lafonti	Savignyella
Sclerodomidae	Ascophora
Onchoporidae	Ascophora
Euthyridellidae	Ascophora
Bifaxariidae	Ascophora
Mamilloporidae	Ascophora
Mamillopora	Mamilloporidae
cupula	Mamillopora
Orbituliporidae	Ascophora
Sphaerulobryozoan	Orbituliporidae
pendunculatum	Sphaerulobryozoan
Conescharellinidae	Ascophora
Myriozoidae	Ascophora
Myriozoum	Myriozoidae
coarctatum	Myriozoum
subgracile	Myriozoum
Myriozoella	Myriozoidae
plana	Myriozoella
Leieschara	Myriozoidae
coarctata	Leieschara
orientalis	Leieschara
subgracilis	Leieschara
Lekythoporidae	Ascophora
Celleporariidae	Ascophora
Celleporaria	Celleporariidae
albirostris	Celleporaria
brunnea	Celleporaria
Vittaticellidae	Ascophora
Vittaticella	Vittaticellidae
uberrima	Vittaticella
elegans	Vittaticella
Exechonellidae	Ascophora
Triporula	Exechonellidae
stellata	Triporula
Porinidae	Ascophora
Escharellidae	Ascophora
Gemellipora	Escharellidae
glabra	Gemellipora
Escharella	Escharellidae
immersa	Escharella
immersa	immersa
labiosa	immersa
microstoma	Escharella
connectens	Escharella
ventricosa	Escharella
ventricosa	ventricosa
peristomata	ventricosa
variolosa	Escharella
dijmphnae	Escharella
indivisa	Escharella
laqueata	Escharella
abyssicola	Escharella
octodentata	Escharella
latodonta	Escharella
macrodonta	Escharella
Hippopodina	Escharellidae
Escharelloides	Escharellidae
spinulifera	Escharelloides
cancellatum	Escharelloides
stenostoma	Escharelloides
simplex	Escharelloides
Lapralioides	Escharellidae
nordlandica	Lapralioides
Phylactella	Escharellidae
labrosa	Phylactella
labiata	Phylactella
pacifica	Phylactella
Smittinidae	Ascophora
Palmicellaria	Smittinidae
skenei	Palmicellaria
skenei	skenei
tridens	skenei
bicornis	skenei
Pseudoflustra	Smittinidae
solida	Pseudoflustra
anderssoni	Pseudoflustra
sinuosa	Pseudoflustra
birulai	Pseudoflustra
Waterisporidae	Ascophora
Waterispora	Waterisporidae
Hippoponellidae	Ascophora
Hippoponella	Hippoponellidae
hippopus	Hippoponella
fastigatoavicularis	Hippoponella
Hippopodinidae	Ascophora
Cheilopora	Hippopodinidae
sincera	Cheilopora
sincera	sincera
praelucida	sincera
inermis	Cheilopora
Phylactolaemata	Ectoprocta
Plumatellida	Phylactolaemata
Plumatellidae	Plumatellida
Plumatella	Plumatellidae
repens	Plumatella
casmiana	Plumatella
fruticosa	Plumatella
emarginata	Plumatella
fungosa	Plumatella
reticulata	Plumatella
tanganyikae	Plumatella
Stolella	Plumatellidae
indica	Stolella
evelinae	Stolella
Hyalinella	Plumatellidae
orbisperma	Hyalinella
punctata	Hyalinella
vaihiriae	Hyalinella
Cristatellidae	Plumatellida
Cristatella	Cristatellidae
mucedo	Cristatella
mucedo	mucedo
idae	mucedo
Lophopodidae	Plumatellida
Lophopodella	Lophopodidae
carteri	Lophopodella
carteri	carteri
typica	carteri
Lophopus	Lophopodidae
crystallinus	Lophopus
Fredericellidae	Plumatellida
Fredericella	Fredericellidae
sultana	Fredericella
sultana	sultana
crenulata	sultana
transcaucasica	sultana
australiensis	Fredericella
Pectinatellidae	Plumatellida
Pectinatella	Pectinatellidae
magnifica	Pectinatella
californica	Bugula
diaphanum	Alcyonidium
kermadecense	Alcyonidium
Elzerina	Flustrellidridae
blainvillii	Elzerina
badia	Elzerina
Bantariella	Mimosellidae
cookae	Bantariella
Penetrantia	Penetrantiidae
densa	Penetrantia
parva	Penetrantia
australis	Aetea
lingulata	Aetea
Gregarinidra	Flustridae
gregaria	Gregarinidra
serrata	Gregarinidra
precocialis	Callopora
alcimum	Amphiblestrum
tuberosa	Alderina
crassimarginata	Crassimarginatella
electra	Crassimarginatella
spathulata	Crassimarginatella
vincularia	Crassimarginatella
corbula	Crassimarginatella
spinosissima	Crassimarginatella
translucens	Crassimarginatella
Marssonopora	Calloporidae
dispersa	Marssonopora
kermadecensis	Marssonopora
Ellisina	Calloporidae
levata	Ellisina
sericea	Ellisina
Onychoblestrum	Calloporidae
hastingsae	Onychoblestrum
multispinosa	Chaperia
Pyrichaperia	Chaperiidae
pyriformis	Pyrichaperia
Chaperiopsis	Chaperiidae
galeata	Chaperiopsis
bispinosa	Chaperiopsis
boninensis	Chaperiopsis
intermediata	Chaperiopsis
multifida	Chaperiopsis
rubida	Chaperiopsis
spiculata	Chaperiopsis
funda	Chaperiopsis
Hiantopora	Hiantoporidae
ferox	Hiantopora
jucunda	Hiantopora
Arachnopusia	Arachnopusiidae
monoceros	Arachnopusia
perforata	Arachnopusia
unicornis	Arachnopusia
Briarachnia	Arachnopusiidae
robusta	Briarachnia
coriacea	coriacea
inarmata	coriacea
elegans	Micropora
rimulata	Micropora
mortenseni	Micropora
multijuncta	Mollia
Monoporella	Microporidae
nodulifera	Monoporella
Manzonella	Microporidae
exilis	Manzonella
monopia	Manzonella
Caleschara	Microporidae
denticulata	Caleschara
levinseni	Caleschara
magnifica	Steginoporella
neozelanica	Steginoporella
rozieri	Thalamoporella
quadrata	Thalamoporella
stapifera	Thalamoporella
humilis	Cellaria
tenuirostris	Cellaria
Stomhypselosaria	Cellariidae
condylata	Stomhypselosaria
Mesostomaria	Cellariidae
strictoramae	Mesostomaria
sessilis	Dendrobeania
Cornucopina	Bugulidae
grandis	Cornucopina
geniculata	Cornucopina
Brettiella	Bugulidae
ovicellata	Brettiella
mirabilis	Beania
bilaminata	Beania
cribrimorpha	Beania
discodermiae	Beania
elongata	Beania
gigantavicularis	Beania
magellanica	Beania
plurispinosa	Beania
maderensis	Scrupocellaria
dichotoma	Caberea
darwinii	Caberea
enzoi	Caberea
glabra	Caberea
helicina	Caberea
rostrata	Caberea
longispinosus	Notoplites
aviculariae	Notoplites
marsupiatus	Notoplites
Amastiga	Scrupocellariidae
nuda	Amastiga
antarctica	Amastiga
antarctica	antarctica
subtropicalis	antarctica
Emma	Scrupocellariidae
crystallina	Emma
watersi	Emma
Canda	Scrupocellariidae
arachnoides	Canda
pecten	Canda
pecten	pecten
scutata	pecten
bifurcata	Membraniporella
figularioides	Membraniporella
furcata	Reginella
stolonifera	Reginella
vas	Reginella
Figularia	Cribrilinidae
figularis	Figularia
carinata	Figularia
spinea	Figularia
huttoni	Figularia
Puellina	Cribrilinidae
gattyae	Puellina
radiata	Puellina
biavicularia	Puellina
innominata	Puellina
Quadricellariidae	Anasca
Quadricellaria	Quadricellariidae
elegans	Quadricellaria
bocki	Quadricellaria
Petalostegidae	Anasca
Petalostegus	Petalostegidae
bicornis	Petalostegus
Macroporidae	Anasca
Macropora	Macroporidae
centralis	Macropora
grandis	Macropora
pacifica	divaricata
calciophilia	Hippothoa
peristomata	Hippothoa
ferocissima	Chorizopora
spicata	Chorizopora
Celleporella	Hippothoidae
hyalina	Celleporella
delta	Celleporella
Gigantopora	Gigantoporidae
lyncoides	Gigantopora
polymorpha	Gigantopora
proximalis	Gigantopora
pupa	Gigantopora
quadrata	Emballotheca
monomorpha	Emballotheca
neptuni	Schizomavella
punctigera	Schizomavella
schizoporelloides	Schizomavella
protrusa	Cleidochasma
waiparaensis	Escharina
Metroperiella	Schizoporellidae
lapralioides	Metroperiella
triangula	Metroperiella
Chiastosella	Schizoporellidae
daedala	Chiastosella
longaevitas	Chiastosella
Nimba	Schizoporellidae
praetexta	Nimba
terraenovae	Nimba
Rogicka	Schizoporellidae
biserialis	Rogicka
oceanica	Rogicka
Phonicosia	Schizoporellidae
jousseaumei	Phonicosia
circinata	Phonicosia
Cribellopora	Schizoporellidae
trichotoma	Cribellopora
simplex	Cribellopora
Lacerna	Schizoporellidae
hosteensis	Lacerna
problematica	Lacerna
Buffonellodes	Schizoporellidae
rimosa	Buffonellodes
marsupifera	Buffonellodes
ridleyi	Buffonellodes
Schizosmittina	Schizoporellidae
planovicellata	Schizosmittina
maplestonei	Schizosmittina
Hippomonavella	Schizoporellidae
praeclara	Hippomonavella
gymnae	Hippomonavella
Smittoidea	Schizoporellidae
prolifica	Smittoidea
curtisensis	Smittoidea
hyalina	Smittoidea
magna	Smittoidea
zelandiae	Smittoidea
Hemismittoidea	Schizoporellidae
corallinea	Hemismittoidea
hexaspinosa	Hemismittoidea
Porelloides	Schizoporellidae
laevis	Porelloides
glabra	Porelloides
pertusa	Hippoporina
cincta	Hippoporina
epaxia	Hippoporina
burlingtoniensis	Hippoporina
rostrata	Hippoporina
Codonellina	Hippoporinidae
galeata	Codonellina
montferrandii	Codonellina
Hippomenella	Hippoporinidae
mucronelliformis	Hippomenella
vellicata	Hippomenella
Hippothyris	Hippoporinidae
emplastra	Hippothyris
aganactete	Hippothyris
angela	Escharoides
excavata	Escharoides
tricuspis	Exochella
Elleschara	Exochellidae
bensoni	Elleschara
agonistes	Microporella
normani	Microporella
discors	Microporella
intermedia	Microporella
lineata	Microporella
orientalis	Microporella
incompta	malusii
pulchra	malusii
catastictos	Fenestrulina
reticulata	Fenestrulina
infundibulipora	Fenestrulina
disjuncta	Fenestrulina
Calloporina	Microporellidae
decorata	Calloporina
angustipora	Calloporina
triporosa	Calloporina
biavicularia	Calloporina
Tenthrenulina	Microporellidae
dispar	Tenthrenulina
foraminigera	Eurystomella
crystallina	Eurystomella
marsupium	Porella
punctata	Smittina
rosacea	Smittina
spiraminifera	Smittina
torques	Smittina
delicatula	Parasmittina
serrula	Parasmittina
tropica	Parasmittina
tubula	Parasmittina
rogickae	Rhamphostomella
mooraboolensis	Lepraliella
multidentata	Lepraliella
angulatum	Rhynchozoon
crenulatum	Rhynchozoon
paa	Rhynchozoon
tubulosum	Rhynchozoon
concinna	Sertella
malleatia	Sertella
Brodiella	Reteporidae
longispinata	Brodiella
foliacea	Adeonellopsis
yarraensis	Adeonellopsis
crinispina	Crepidacantha
bracebridgei	Crepidacantha
costazii	Celleporina
spatula	Celleporina
Galeopsis	Celleporidae
rabidus	Galeopsis
pentagonus	Galeopsis
polyporus	Galeopsis
Buffonellaria	Celleporidae
divergens	Buffonellaria
biavicularis	Buffonellaria
christinelloides	Buffonellaria
depressa	Buffonellaria
regenerata	Buffonellaria
lepralioides	Lagenipora
crenulata	Lagenipora
ferocissima	Lagenipora
hemiperistomata	Lagenipora
laevissima	Lagenipora
Osthimosia	Celleporidae
eatonensis	Osthimosia
bicornis	Osthimosia
imperforata	Osthimosia
incomposita	Osthimosia
virgula	Osthimosia
Catenicella	Catenicellidae
contei	Catenicella
elegans	Catenicella
venusta	Catenicella
Pterocella	Catenicellidae
alata	Pterocella
Orthoscuticella	Catenicellidae
lorica	Orthoscuticella
cristata	Celleporaria
tridenticulata	Celleporaria
grandis	Exechonella
tuberculata	Exechonella
Haswellina	Porinidae
australiensis	Haswellina
multiaviculata	Haswellina
incudifera	Escharella
Petraliellidae	Ascophora
Discopora	Petraliellidae
verrucosa	Discopora
intermediata	Discopora
Teuchoporidae	Ascophora
Lagenicella	Teuchoporidae
marginata	Lagenicella
exallos	Lagenicella
lacunosa	Lagenicella
Inversiulidae	Ascophora
Inversiula	Inversiulidae
nutrix	Inversiula
fertilis	Inversiula
Calwelliidae	Ascophora
Calwellia	Calwelliidae
bicornis	Calwellia
sinclairii	Calwellia
cellaroides	Alcyonidium
fibrosum	Arachnidium
Bulbella	Arachnidiidae
abscondita	Bulbella
pusilla	Nolella
Monobryozoontidae	Paludicelloidea
Monobryozoon	Monobryozoontidae
ambulans	Monobryozoon
pruvoti	Amathia
guernseii	Amathia
intermedis	Amathia
citrina	Bowerbankia
gracillima	Bowerbankia
spinosa	Vesicularia
Spathiporidae	Vesicularioidea
Spathipora	Spathiporidae
sertum	Spathipora
Walkeria	Walkeriidae
uva	Walkeria
Mimosella	Mimosellidae
gracilis	Mimosella
verticillata	Mimosella
Hypophorellidae	Stolonifera
Hypophorella	Hypophorellidae
expansa	Hypophorella
concharum	Penetrantia
Immergentia	Immergentiidae
suecica	Immergentia
ramosa	Crisia
calyptostoma	Crisia
klugei	Crisia
lobifera	Tubulipora
phalangea	Tubulipora
plumosa	Tubulipora
dilatans	Oncousoecia
Entalophoroecia	Entalophoridae
deflexa	Entalophoroecia
sarniensis	Plagioecia
Coronopora	Lichenoporidae
truncata	Coronopora
monostachys	Electra
Chartella	Flustridae
barleei	Chartella
papyracea	Chartella
flustroides	Hincksina
discreta	Callopora
rylandi	Callopora
solidum	Amphiblestrum
exiguum	Copidozoum
planum	Copidozoum
solidula	Crassimarginatella
normani	Micropora
rosselii	Mollia
Calpensia	Microporidae
nobilis	Calpensia
Setosella	Setosellidae
vulnerata	Setosella
Lagarozoum	Setosellidae
salicornioides	Cellaria
purpurotincta	Bugula
simplex	Bugula
intermedia	Beania
inermis	Scrupocellaria
reptans	Scrupocellaria
damicornis	Notoplites
evocata	Notoplites
harmeri	Notoplites
Epistomia	Epistomiidae
bursaria	Epistomia
setosa	Puellina
venusta	Puellina
bifida	Puellina
modica	Puellina
praecox	Puellina
directa	Puellina
arrecta	Puellina
corbula	Puellina
bimucronatum	Haplopoma
graniferum	Haplopoma
planum	Haplopoma
sciaphilum	Haplopoma
Plesiothoa	Hippothoidae
gigerium	Plesiothoa
ovicellata	Umbonula
dunkeri	Schizoporella
longirostris	Schizoporella
magnifica	Schizoporella
cuspida	auriculata
linearis	linearis
hastata	linearis
cristata	Schizomavella
discoidea	Schizomavella
hastiformis	Schizomavella
umbonata	Schizomavella
alderi	Escharina
dutertrei	Escharina
hyndmanni	Escharina
johnstoni	Escharina
amplissima	Smittoidea
marmorea	Smittoidea
reticulata	Smittoidea
struma	Porelloides
Phaeostachys	Schizoporellidae
spinifera	Phaeostachys
lusitania	Hippoporidra
mamillata	Escharoides
Diporula	Microporellidae
verrucosa	Diporula
alba	Porella
patula	Porella
affinis	Smittina
crystallina	Smittina
microstoma	Hemicyclopora
Prenantia	Mucronellidae
bella	Prenantia
cheilostoma	Prenantia
divisa	Schizotheca
armata	Brodiella
Reteporella	Reteporidae
couchii	Reteporella
septentrionalis	Reteporella
avicularis	Turbicellepora
magnicostata	Turbicellepora
smitti	Turbicellepora
decipiens	Celleporina
tubulosa	Celleporina
quincuncialis	Buskea
pygmaea	Lagenipora
Anarthropora	Exechonellidae
monodon	Anarthropora
klugei	Escharella
labiosa	Escharella
Phylactellipora	Escharellidae
collaris	Phylactellipora
eximia	Phylactellipora
elegans	Palmicellaria
Watersiporidae	Ascophora
Watersipora	Watersiporidae
complanata	Watersipora
Cryptosulidae	Ascophora
Cleidochasmatidae	Ascophora
Hippopodinella	Cleidochasmatidae
Tessaradomidae	Ascophora
boreale	Tessaradoma
hirtissima	Beania
labiata	Phidolopora
