Ectoprocta	Animalia	extra stuff here	syn1|syn2|syn3
Gymnolaemata	Ectoprocta	author date something	syn4|syn5
Ctenostomata	Gymnolaemata	more stuff	syn6
Carnosa	Ctenostomata	something something	syn7
Alcyonidiidae	Carnosa	more stuff
Alcyonidium	Alcyonidiidae	extra message
polyoum	Alcyonidium
mamillatum	Alcyonidium
mamillatum	mamillatum
erectum	mamillatum
pedunculatum	Alcyonidium
disciforme	Alcyonidium
enteromorpha	Alcyonidium
parasiticum	Alcyonidium
verrilli	Alcyonidium
mytili	Alcyonidium
vermiculare	Alcyonidium
gelatinosum	Alcyonidium
gelatinosum	gelatinosum
diaphanum	gelatinosum
anderssoni	gelatinosum
pachydermatum	gelatinosum
