unit_name1	rank_name	parent_name	usage
bryozoa	Phylum	animalia	valid
stenolaemata	Class	bryozoa	valid
gymnolaemata	Class	bryozoa	valid
phylactolaemata	Class	bryozoa	valid
cyclostomata	Order	stenolaemata	valid
hederellida	Order	stenolaemata	valid
cryptostomida	Order	stenolaemata	valid
cystoporida	Order	stenolaemata	valid
trepostomatida	Order	stenolaemata	valid
fenestrida	Order	stenolaemata	valid
ctenostomata	Order	gymnolaemata	valid
cheilostomata	Order	gymnolaemata	valid
plumatellida	Order	phylactolaemata	valid
inovicellina	Suborder	cheilostomata	valid
malacostegina	Suborder	cheilostomata	valid
neocheilostomina	Suborder	cheilostomata	valid
scrupariina	Suborder	cheilostomata	valid
uncertain	Suborder	cheilostomata	valid
articulina	Suborder	cyclostomata	valid
cancellata	Suborder	cyclostomata	valid
cerioporina	Suborder	cyclostomata	valid
paleotubuliporina	Suborder	cyclostomata	valid
rectangulata	Suborder	cyclostomata	valid
tubuliporina	Suborder	cyclostomata	valid
uncertain	Suborder	cyclostomata	valid
alcyonidiina	Suborder	ctenostomata	valid
flustrellidrina	Suborder	ctenostomata	valid
paludicellina	Suborder	ctenostomata	valid
protoctenostamata	Suborder	ctenostomata	valid
protoctenostomata	Suborder	ctenostomata	valid
stoloniferina	Suborder	ctenostomata	valid
vesicularina	Suborder	ctenostomata	valid
victorellina	Suborder	ctenostomata	valid
uncertain	Suborder	ctenostomata	valid
ptilodictyina	Suborder	cryptostomida	valid
rhabdomesina	Suborder	cryptostomida	valid
timanodictyina	Suborder	cryptostomida	valid
goldfussitrypina	Suborder	cryptostomida	valid
strebolotrypina	Suborder	cryptostomida	valid
ceramoporina	Suborder	cystoporida	valid
fistuliporina	Suborder	cystoporida	valid
uncertain	Suborder	cyclostomata	valid
uncertain	Suborder	ctenostomata	valid
uncertain	Suborder	cheilostomata	valid
ascophorina	Infraorder	neocheilostomina	valid
flustrina	Infraorder	neocheilostomina	valid
uncertain	Infraorder	uncertain	valid
uncertain	Infraorder	uncertain	valid
uncertain	Infraorder	uncertain	valid
uncertain	Infraorder	uncertain	valid
aeverrillioidea	Superfamily	stoloniferina	valid
alcyonidoidea	Superfamily	alcyonidiina	valid
arachnidioidea	Superfamily	stoloniferina	valid
benedeniporoidea	Superfamily	protoctenostamata	valid
flustrellidroidea	Superfamily	flustrellidrina	valid
haywardozoonoidea	Superfamily	flustrellidrina	valid
hislopioidea	Superfamily	stoloniferina	valid
paludicelloidea	Superfamily	paludicellina	valid
penetrantiina	Superfamily	stoloniferina	valid
terebriporoidea	Superfamily	stoloniferina	valid
triticelloidea	Superfamily	stoloniferina	valid
uncertain	Superfamily	uncertain	valid
valkerioidea	Superfamily	stoloniferina	valid
vesicularioidea	Superfamily	vesicularina	valid
victorelloidea	Superfamily	victorellina	valid
adeonoidea	Superfamily	ascophorina	valid
aeteoidea	Superfamily	inovicellina	valid
arachnopusioidea	Superfamily	ascophorina	valid
bifaxarioidea	Superfamily	ascophorina	valid
buguloidea	Superfamily	flustrina	valid
calloporoidea	Superfamily	flustrina	valid
catenicelloidea	Superfamily	ascophorina	valid
cellarioidea	Superfamily	flustrina	valid
celleporoidea	Superfamily	ascophorina	valid
conescharellinoidea	Superfamily	ascophorina	valid
cribrilinoidea	Superfamily	ascophorina	valid
didymoselloidea	Superfamily	ascophorina	valid
dysnoetoporoidea	Superfamily	ascophorina	valid
euthyriselloidea	Superfamily	ascophorina	valid
flustroidea	Superfamily	neocheilostomina	valid
hippothooidea	Superfamily	ascophorina	valid
lepralielloidea	Superfamily	ascophorina	valid
mamilloporoidea	Superfamily	ascophorina	valid
membraniporoidea	Superfamily	malacostegina	valid
microporoidea	Superfamily	neocheilostomina	valid
pseudolepralioidea	Superfamily	ascophorina	valid
schizoporelloidea	Superfamily	ascophorina	valid
scorioporoidea	Superfamily	ascophorina	valid
scruparioidea	Superfamily	scrupariina	valid
siphonicytaroidea	Superfamily	ascophorina	valid
smittinoidea	Superfamily	ascophorina	valid
uncertain	Superfamily	neocheilostomina	valid
uncertain	Superfamily	ascophorina	valid
uncertain	Superfamily	ascophorina	valid
uncertain	Superfamily	uncertain	valid
uncertain	Superfamily	ascophorina	valid
uncertain	Superfamily	ascophorina	valid
urceoliporoidea	Superfamily	ascophorina	valid
batoporoidea	Superfamily	ascophorina	valid
uncertain	Superfamily	uncertain	valid
uncertain	Superfamily	uncertain	valid
uncertain	Superfamily	uncertain	valid
hederellidae	Family	hederellida	valid
reptariidae	Family	hederellida	valid
aisenvergiidae	Family	trepostomatida	valid
amplexoporidae	Family	trepostomatida	valid
anisotrypidae	Family	trepostomatida	valid
araxoporidae	Family	trepostomatida	valid
astralochomidae	Family	trepostomatida	valid
atactotoechidae	Family	trepostomatida	valid
batostomellidae	Family	trepostomatida	valid
bimuroporidae	Family	trepostomatida	valid
crustoporidae	Family	trepostomatida	valid
cycloporidae	Family	trepostomatida	valid
dianulitidae	Family	trepostomatida	valid
diplotrypidae	Family	trepostomatida	valid
dittoporidae	Family	trepostomatida	valid
dyscritellidae	Family	trepostomatida	valid
eridotrypellidae	Family	trepostomatida	valid
esthonioporidae	Family	trepostomatida	valid
girtyporidae	Family	trepostomatida	valid
halloporidae	Family	trepostomatida	valid
helenoporidae	Family	trepostomatida	valid
hemieridotrypidae	Family	trepostomatida	valid
heterotrypidae	Family	trepostomatida	valid
leioclemidae	Family	trepostomatida	valid
maychellinidae	Family	trepostomatida	valid
mesotrypidae	Family	trepostomatida	valid
mishulgellidae	Family	trepostomatida	valid
monticuliporidae	Family	trepostomatida	valid
nipponostenoporidae	Family	trepostomatida	valid
orbiporidae	Family	trepostomatida	valid
pseudocampylidae	Family	trepostomatida	valid
ralfimartitidae	Family	trepostomatida	valid
revalotrypidae	Family	trepostomatida	valid
stenoporellidae	Family	trepostomatida	valid
stenoporidae	Family	trepostomatida	valid
stereotoechidae	Family	trepostomatida	valid
trematoporidae	Family	trepostomatida	valid
ulrichotrypellidae	Family	trepostomatida	valid
zozariellidae	Family	trepostomatida	valid
acanthocladiidae	Family	fenestrida	valid
admiratellidae	Family	fenestrida	valid
carnocladiidae	Family	fenestrida	valid
chainodictyonidae	Family	fenestrida	valid
enalloporidae	Family	fenestrida	valid
fenestellidae	Family	fenestrida	valid
fenestraliidae	Family	fenestrida	valid
fenestraporidae	Family	fenestrida	valid
phylloporinidae	Family	fenestrida	valid
polyporidae	Family	fenestrida	valid
ralfinidae	Family	fenestrida	valid
sardesoninidae	Family	fenestrida	valid
semicosciniidae	Family	fenestrida	valid
septatoporidae	Family	fenestrida	valid
septoporidae	Family	fenestrida	valid
ptilodictyidae	Family	ptilodictyina	valid
escharoporidae	Family	ptilodictyina	valid
intraporidae	Family	ptilodictyina	valid
phragmopheridae	Family	ptilodictyina	valid
rhinidictyidae	Family	ptilodictyina	valid
stictoporellidae	Family	ptilodictyina	valid
chiplonkarinidae	Family	membraniporoidea	valid
phaenoporidae	Family	ptilodictyina	valid
worthenoporidae	Family	ptilodictyina	valid
arthrostylidae	Family	rhabdomesina	valid
rhabdomesidae	Family	rhabdomesina	valid
rhomboporidae	Family	rhabdomesina	valid
bactroporidae	Family	rhabdomesina	valid
nikiforovellidae	Family	rhabdomesina	valid
pseudoascoporidae	Family	rhabdomesina	valid
hyphasmoporidae	Family	rhabdomesina	valid
streblascoporidae	Family	rhabdomesina	valid
timanodictyidae	Family	timanodictyina	valid
murengoloclemidae	Family	timanodictyina	valid
goldfussitrypidae	Family	goldfussitrypina	valid
maychellidae	Family	goldfussitrypina	valid
mediaporidae	Family	goldfussitrypina	valid
nicklesoporidae	Family	goldfussitrypina	valid
nudymiellidae	Family	strebolotrypina	valid
nematoporidae	Family	strebolotrypina	valid
nematotrypidae	Family	strebolotrypina	valid
ceramoporidae	Family	ceramoporina	valid
acanthoceramoporellidae	Family	ceramoporina	valid
rhinoporidae	Family	ceramoporina	valid
anolotichiidae	Family	fistuliporina	valid
xenotrypidae	Family	fistuliporina	valid
constellariidae	Family	fistuliporina	valid
fistuliporidae	Family	fistuliporina	valid
botrylloporidae	Family	fistuliporina	valid
actinotrypidae	Family	fistuliporina	valid
hexagonellidae	Family	fistuliporina	valid
cystodictyonidae	Family	fistuliporina	valid
etherellidae	Family	fistuliporina	valid
goniocladiidae	Family	fistuliporina	valid
annectocymidae	Family	tubuliporina	valid
canaliporidae	Family	cancellata	valid
cavidae	Family	cerioporina	valid
celluliporidae	Family	tubuliporina	valid
cerioporidae	Family	cerioporina	valid
cinctiporidae	Family	tubuliporina	valid
clausidae	Family	cerioporina	valid
corymboporidae	Family	cerioporina	valid
corynotrypidae	Family	paleotubuliporina	valid
crassodiscoporidae	Family	cancellata	valid
crisiidae	Family	articulina	valid
crisinidae	Family	cancellata	valid
crisuliporidae	Family	tubuliporina	valid
crownoporidae	Family	paleotubuliporina	valid
cytididae	Family	cancellata	valid
densiporidae	Family	cerioporina	valid
diaperoeciidae	Family	tubuliporina	valid
diastoporidae	Family	tubuliporina	valid
eleidae	Family	tubuliporina	valid
entalophoridae	Family	tubuliporina	valid
filisparsidae	Family	tubuliporina	valid
frondiporidae	Family	tubuliporina	valid
hastingsiidae	Family	tubuliporina	valid
heteroporidae	Family	cerioporina	valid
horneridae	Family	cancellata	valid
idmoneidae	Family	tubuliporina	valid
leiosoeciidae	Family	cerioporina	valid
lichenoporidae	Family	rectangulata	valid
lobosoeciidae	Family	tubuliporina	valid
mecynoeciidae	Family	tubuliporina	valid
multisparsidae	Family	tubuliporina	valid
oncousoeciidae	Family	tubuliporina	valid
petaloporidae	Family	cancellata	valid
pseudidmoneidae	Family	cancellata	valid
pseudocerioporidae	Family	cerioporina	valid
pustuloporidae	Family	tubuliporina	valid
sagenellidae	Family	paleotubuliporina	valid
semiceidae	Family	tubuliporina	valid
siphoniotyphlidae	Family	tubuliporina	valid
spiroporidae	Family	tubuliporina	valid
stigmatoechidae	Family	cancellata	valid
stomatoporidae	Family	tubuliporina	valid
terviidae	Family	tubuliporina	valid
theonoidae	Family	tubuliporina	valid
tubuliporidae	Family	tubuliporina	valid
uncertain	Family	cerioporina	valid
uncertain	Family	paleotubuliporina	valid
uncertain	Family	tubuliporina	valid
uncertain	Family	uncertain	valid
aethozoontidae	Family	victorelloidea	valid
aeverrilliidae	Family	aeverrillioidea	valid
alcyonidiidae	Family	alcyonidoidea	valid
arachnidiidae	Family	arachnidioidea	valid
ascodictyidae	Family	uncertain	valid
bathyalozoontidae	Family	vesicularioidea	valid
benedeniporidae	Family	benedeniporoidea	valid
buskiidae	Family	vesicularioidea	valid
clavoporidae	Family	alcyonidoidea	valid
cookobryozoonidae	Family	terebriporoidea	valid
farrellidae	Family	aeverrillioidea	valid
flustrellidridae	Family	flustrellidroidea	valid
harmeriellidae	Family	valkerioidea	valid
haywardozoontidae	Family	haywardozoonoidea	valid
hislopiidae	Family	hislopioidea	valid
hypophorellidae	Family	valkerioidea	valid
immergentiidae	Family	victorelloidea	valid
labiostomellidae	Family	benedeniporoidea	valid
mimosellidae	Family	valkerioidea	valid
monobryozoontidae	Family	alcyonidoidea	valid
nolellidae	Family	victorelloidea	valid
orbignyoporidae	Family	terebriporoidea	valid
pachyzoontidae	Family	alcyonidoidea	valid
paludicellidae	Family	paludicelloidea	valid
penetrantiidae	Family	penetrantiina	valid
pherusellidae	Family	flustrellidroidea	valid
pottsiellidae	Family	victorelloidea	valid
ropalonariidae	Family	terebriporoidea	valid
spathiporidae	Family	terebriporoidea	valid
sundanellidae	Family	victorelloidea	valid
terebriporidae	Family	terebriporoidea	valid
triticellidae	Family	triticelloidea	valid
uncertain	Family	uncertain	valid
uncertain	Family	benedeniporoidea	valid
uncertain	Family	uncertain	valid
plagioeciidae	Family	tubuliporina	valid
diploclemidae	Family	tubuliporina	valid
gemelliporellidae	Family	lepralielloidea	valid
sfeniellidae	Family	lepralielloidea	valid
actisecidae	Family	schizoporelloidea	valid
adeonellidae	Family	adeonoidea	valid
adeonidae	Family	adeonoidea	valid
aeteidae	Family	aeteoidea	valid
alysidiidae	Family	microporoidea	valid
antroporidae	Family	calloporoidea	valid
arachnopusiidae	Family	arachnopusioidea	valid
ascosiidae	Family	mamilloporoidea	valid
aspidostomatidae	Family	microporoidea	valid
batoporidae	Family	batoporoidea	valid
beaniidae	Family	buguloidea	valid
belluloporidae	Family	cribrilinoidea	valid
bicorniferidae	Family	uncertain	valid
bifaxariidae	Family	bifaxarioidea	valid
bitectiporidae	Family	smittinoidea	valid
brydonellidae	Family	pseudolepralioidea	valid
bryobaculidae	Family	schizoporelloidea	valid
bryocryptellidae	Family	lepralielloidea	valid
bryopastoridae	Family	calloporoidea	valid
buffonellodidae	Family	schizoporelloidea	valid
bugulidae	Family	buguloidea	valid
calescharidae	Family	microporoidea	valid
calloporidae	Family	calloporoidea	valid
calwelliidae	Family	schizoporelloidea	valid
candidae	Family	buguloidea	valid
catenicellidae	Family	catenicelloidea	valid
cellariidae	Family	cellarioidea	valid
celleporidae	Family	celleporoidea	valid
chaperiidae	Family	calloporoidea	valid
cheilhorneropsidae	Family	uncertain	valid
cheiloporinidae	Family	schizoporelloidea	valid
chlidoniidae	Family	microporoidea	valid
chlidoniopsidae	Family	lepralielloidea	valid
chorizoporidae	Family	hippothooidea	valid
cleidochasmatidae	Family	mamilloporoidea	valid
colatooeciidae	Family	celleporoidea	valid
concatenellidae	Family	catenicelloidea	valid
conescharellinidae	Family	batoporoidea	valid
corynostylidae	Family	membraniporoidea	valid
coscinopleuridae	Family	cellarioidea	valid
crepidacanthidae	Family	mamilloporoidea	valid
cribrilinidae	Family	cribrilinoidea	valid
cryptosulidae	Family	schizoporelloidea	valid
cupuladriidae	Family	calloporoidea	valid
cuvillieridae	Family	batoporoidea	valid
cyclicoporidae	Family	schizoporelloidea	valid
dhondtiscidae	Family	lepralielloidea	valid
didymosellidae	Family	didymoselloidea	valid
doryporellidae	Family	calloporoidea	valid
duvergieriidae	Family	schizoporelloidea	valid
dysnoetoporidae	Family	dysnoetoporoidea	valid
echinovadomidae	Family	schizoporelloidea	valid
electridae	Family	membraniporoidea	valid
eminooeciidae	Family	schizoporelloidea	valid
epistomiidae	Family	buguloidea	valid
escharinidae	Family	schizoporelloidea	valid
eucrateidae	Family	scruparioidea	valid
euoplozoidae	Family	buguloidea	valid
eurystomellidae	Family	catenicelloidea	valid
euthyroididae	Family	cribrilinoidea	valid
exechonellidae	Family	arachnopusioidea	valid
farciminariidae	Family	calloporoidea	valid
flustridae	Family	flustroidea	valid
foveolariidae	Family	calloporoidea	valid
fusicellariidae	Family	uncertain	valid
gigantoporidae	Family	schizoporelloidea	valid
haplopomidae	Family	hippothooidea	valid
heliodomidae	Family	calloporoidea	valid
hiantoporidae	Family	calloporoidea	valid
hincksiporidae	Family	lepralielloidea	valid
hippaliosinidae	Family	schizoporelloidea	valid
hippopodinidae	Family	schizoporelloidea	valid
hippoporidridae	Family	celleporoidea	valid
hippothoidae	Family	hippothooidea	valid
inversiulidae	Family	adeonoidea	valid
jaculinidae	Family	schizoporelloidea	valid
jubellidae	Family	buguloidea	valid
lacernidae	Family	schizoporelloidea	valid
lanceoporidae	Family	schizoporelloidea	valid
acoraniidae	Family	schizoporelloidea	valid
actinoporidae	Family	tubuliporina	valid
arcanoporidae	Family		valid
beisselinidae	Family		valid
bicellariellidae	Family		valid
columnothecidae	Family		valid
cristatellidae	Family	plumatellida	valid
ditaxiporinidae	Family		valid
exochellidae	Family	lepralielloidea	valid
flabellotrypidae	Family	paleotubuliporina	valid
fredericellidae	Family	plumatellida	valid
hesychoxeniidae	Family		valid
kielceporidae	Family	cryptostomida	valid
labioporellidae	Family		valid
lophopodidae	Family	plumatellida	valid
lyroporinae	Family		valid
nematoporellidae	Family		valid
palescharidae	Family	cryptostomida	valid
pectinatellidae	Family	plumatellida	valid
nephroporidae	Family	scorioporoidea	valid
onychocellidae	Family	microporoidea	valid
orbituliporidae	Family	batoporoidea	valid
otionellidae	Family	microporoidea	valid
pacificincolidae	Family	schizoporelloidea	valid
pasytheidae	Family	hippothooidea	valid
petalostegidae	Family	catenicelloidea	valid
petraliellidae	Family	schizoporelloidea	valid
petraliidae	Family	schizoporelloidea	valid
phidoloporidae	Family	celleporoidea	valid
phoceanidae	Family	schizoporelloidea	valid
phorioppniidae	Family	schizoporelloidea	valid
platyglenidae	Family	bifaxarioidea	valid
polliciporidae	Family	cribrilinoidea	valid
poricellariidae	Family	microporoidea	valid
porinidae	Family	schizoporelloidea	valid
prostomariidae	Family	urceoliporoidea	valid
pseudolepraliidae	Family	pseudolepralioidea	valid
quadricellariidae	Family	calloporoidea	valid
rhabdozoidae	Family	buguloidea	valid
romancheinidae	Family	lepralielloidea	valid
savignyellidae	Family	catenicelloidea	valid
schizoporellidae	Family	schizoporelloidea	valid
sclerodomidae	Family	lepralielloidea	valid
scorioporidae	Family	scorioporoidea	valid
scrupariidae	Family	scruparioidea	valid
selenariidae	Family	microporoidea	valid
setosellidae	Family	microporoidea	valid
siphonicytaridae	Family	siphonicytaroidea	valid
skyloniidae	Family	uncertain	valid
smittinidae	Family	smittinoidea	valid
steginoporellidae	Family	microporoidea	valid
stomachetosellidae	Family	schizoporelloidea	valid
tendridae	Family	calloporoidea	valid
tessaradomidae	Family	lepralielloidea	valid
tetraplariidae	Family	schizoporelloidea	valid
teuchoporidae	Family	schizoporelloidea	valid
thalamoporellidae	Family	microporoidea	valid
torquatellidae	Family	celleporoidea	valid
trypostegidae	Family	hippothooidea	valid
umbonulidae	Family	lepralielloidea	valid
uncertain	Family	calloporoidea	valid
uncertain	Family	schizoporelloidea	valid
uncertain	Family	adeonoidea	valid
uncertain	Family	microporoidea	valid
uncertain	Family	mamilloporoidea	valid
uncertain	Family	celleporoidea	valid
uncertain	Family	uncertain	valid
uncertain	Family	uncertain	valid
uncertain	Family	uncertain	valid
uncertain	Family	smittinoidea	valid
uncertain	Family	uncertain	valid
uncertain	Family	uncertain	valid
calvetiidae	Family	cancellata	valid
watersiporidae	Family	smittinoidea	valid
wawaliidae	Family	membraniporoidea	valid
euthyrisellidae	Family	euthyriselloidea	valid
uncertain	Family	buguloidea	valid
uncertain	Family	didymoselloidea	valid
uncertain	Family	dysnoetoporoidea	valid
uncertain	Family	membraniporoidea	valid
uncertain	Family	uncertain	valid
uncertain	Family	scorioporoidea	valid
uncertain	Family	uncertain	valid
uncertain	Family	uncertain	valid
peedeesellidae	Family	lepralielloidea	valid
phaceloporidae	Family	tubuliporina	valid
phragmoporidae	Family		valid
plumatellidae	Family	plumatellida	valid
ptyloporidae	Family		valid
radioporidae	Family	cancellata	valid
setosellinidae	Family		valid
stephanellidae	Family	plumatellida	valid
taenioporinidae	Family		valid
tamaroclemidae	Family	cryptostomida	valid
vidronovellidae	Family	goldfussitrypina	valid
membraniporidae	Family	membraniporoidea	valid
lepraliellidae	Family	lepralielloidea	valid
lunulitidae	Family	microporoidea	valid
metrarabdotosidae	Family	lepralielloidea	valid
aethozoon	Genus	aethozoontidae	valid
aeverrillia	Genus	aeverrilliidae	valid
alcyonidioides	Genus	alcyonidiidae	valid
alcyonidium	Genus	alcyonidiidae	valid
allonema	Genus	diploclemidae	valid
amathia	Genus	uncertain	valid
anguinella	Genus	nolellidae	valid
arachnidium	Genus	arachnidiidae	valid
arachnoidea	Genus	arachnidiidae	valid
arachnoidella	Genus	arachnidiidae	valid
ascodictyon	Genus	ascodictyidae	valid
ascorhiza	Genus	clavoporidae	valid
avenella	Genus	uncertain	valid
bantariella	Genus	mimosellidae	valid
bascomella	Genus	ascodictyidae	valid
bathyalozoon	Genus	bathyalozoontidae	valid
benedenipora	Genus	benedeniporidae	valid
bockiella	Genus	flustrellidridae	valid
bowerbankia	Genus	uncertain	valid
bulbella	Genus	plagioeciidae	valid
cardoarachnidium	Genus	arachnidiidae	valid
casteropora	Genus	uncertain	valid
clavopora	Genus	clavoporidae	valid
condranema	Genus	diploclemidae	valid
cookobryozoon	Genus	cookobryozoonidae	valid
crassicaula	Genus	uncertain	valid
cryptoarachnidium	Genus	arachnidiidae	valid
cryptopolyzoon	Genus	buskiidae	valid
eliasopora	Genus	ascodictyidae	valid
elzerina	Genus	flustrellidridae	valid
farrella	Genus	farrellidae	valid
fischerella	Genus	uncertain	valid
flustrellidra	Genus	flustrellidridae	valid
flustrellidrella	Genus	flustrellidridae	valid
foraripora	Genus	uncertain	valid
franzenella	Genus	arachnidiidae	valid
haimeina	Genus	uncertain	valid
harmeriella	Genus	harmeriellidae	valid
haywardozoon	Genus	haywardozoontidae	valid
hislopia	Genus	hislopiidae	valid
huxleya	Genus	uncertain	valid
hypophorella	Genus	hypophorellidae	valid
immergentia	Genus	immergentiidae	valid
iramena	Genus	uncertain	valid
labiostomella	Genus	labiostomellidae	valid
lobiancopora	Genus	alcyonidiidae	valid
marcusopora	Genus	uncertain	valid
metalcyonidium	Genus	clavoporidae	valid
mimosella	Genus	mimosellidae	valid
monastesia	Genus	sfeniellidae	valid
monobryozoon	Genus	monobryozoontidae	valid
neobockiella	Genus	flustrellidridae	valid
neoflustrellidra	Genus	flustrellidridae	valid
nolella	Genus	nolellidae	valid
orbignyopora	Genus	orbignyoporidae	valid
pachyzoon	Genus	pachyzoontidae	valid
paludicella	Genus	paludicellidae	valid
panolicella	Genus	uncertain	valid
parachnoidea	Genus	arachnidiidae	valid
paralcyonidium	Genus	alcyonidiidae	valid
paravinella	Genus	diploclemidae	valid
penetrantia	Genus	penetrantiidae	valid
pherusella	Genus	pherusellidae	valid
platypolyzoon	Genus	nolellidae	valid
pottsiella	Genus	pottsiellidae	valid
protobenedenipora	Genus	uncertain	valid
pseudalcyonidium	Genus	clavoporidae	valid
ropalonaria	Genus	ropalonariidae	valid
simplicidium	Genus	arachnidiidae	valid
sineportella	Genus	plagioeciidae	valid
spathipora	Genus	spathiporidae	valid
stolonicella	Genus	uncertain	valid
sundanella	Genus	sundanellidae	valid
syringothenia	Genus	alcyonidiidae	valid
tanganella	Genus	plagioeciidae	valid
terebripora	Genus	terebriporidae	valid
triticella	Genus	triticellidae	valid
triticellopsis	Genus	triticellidae	valid
vesicularia	Genus	uncertain	valid
victorella	Genus	plagioeciidae	valid
vinella	Genus	diploclemidae	valid
voigtella	Genus	gemelliporellidae	valid
walkeria	Genus	sfeniellidae	valid
zoobotryon	Genus	uncertain	valid
uncertain	Genus	uncertain	valid
uncertain	Genus	uncertain	valid
uncertain	Genus	uncertain	valid
abdomenopora	Genus	cribrilinidae	valid
aberrodomus	Genus	bifaxariidae	valid
acanthobaktron	Genus	cribrilinidae	valid
acanthodesiomorpha	Genus	uncertain	valid
acanthophragma	Genus	beisselinidae	valid
acanthoporella	Genus	calloporidae	valid
acanthoporidra	Genus	calloporidae	valid
acerinucleus	Genus	cellariidae	valid
acoscinopleura	Genus	coscinopleuridae	valid
actisecos	Genus	actisecidae	valid
adelascopora	Genus	labioporellidae	valid
adenifera	Genus	calloporidae	valid
adeona	Genus	adeonidae	valid
adeonella	Genus	adeonellidae	valid
adeonellopsis	Genus	adeonidae	valid
aechmella	Genus	onychocellidae	valid
aegyptopora	Genus	umbonulidae	valid
aeolopora	Genus	cribrilinidae	valid
aequilumina	Genus	kielceporidae	valid
aetea	Genus	aeteidae	valid
ahcheethamia	Genus	catenicellidae	valid
aimulosia	Genus	buffonellodidae	valid
akatopora	Genus	antroporidae	valid
alderina	Genus	calloporidae	valid
alismittina	Genus	smittinidae	valid
allantocallopora	Genus	calloporidae	valid
allantopora	Genus	calloporidae	valid
allerescha	Genus	romancheinidae	valid
alysidium	Genus	alysidiidae	valid
amastigia	Genus	candidae	valid
ammatophora	Genus	calloporidae	valid
amphiblestrella	Genus	chaperiidae	valid
anaptopora	Genus	cribrilinidae	valid
anarthropora	Genus	adeonidae	valid
anaskopora	Genus	cribrilinidae	valid
anchicleidochasma	Genus	cleidochasmatidae	valid
andreella	Genus	lyroporinae	valid
andriopora	Genus	cribrilinidae	valid
anexechona	Genus	exechonellidae	valid
angelopora	Genus	cribrilinidae	valid
anornithopora	Genus	cribrilinidae	valid
anoteropora	Genus	ditaxiporinidae	valid
anotopora	Genus	cribrilinidae	valid
antarcticaetos	Genus	romancheinidae	valid
antropora	Genus	antroporidae	valid
apiophragma	Genus	lyroporinae	valid
aplousina	Genus	calloporidae	valid
aptonella	Genus	gigantoporidae	valid
arachnopusia	Genus	arachnopusiidae	valid
arctonula	Genus	romancheinidae	valid
argopora	Genus	cribrilinidae	valid
arthropoma	Genus	lacernidae	valid
ascancestor	Genus	cribrilinidae	valid
ascosia	Genus	ascosiidae	valid
aspericreta	Genus	smittinidae	valid
aspidelectra	Genus	electridae	valid
aspidostoma	Genus	aspidostomatidae	valid
astochoporella	Genus	umbonulidae	valid
astoleiosalpinx	Genus	acoraniidae	valid
atactoporidra	Genus	batoporidae	valid
atelestozoum	Genus	cellariidae	valid
auchenopora	Genus	cribrilinidae	valid
aulopocella	Genus	arcanoporidae	valid
austroflustra	Genus	flustridae	valid
amphiblestrum	Genus	calloporidae	valid
aviculiera	Genus	lyroporinae	valid
babickella	Genus	bicorniferidae	valid
bactrellaria	Genus	candidae	valid
bactridium	Genus	escharinidae	valid
balantiostoma	Genus	beisselinidae	valid
baptopora	Genus	cribrilinidae	valid
bathosella	Genus	romancheinidae	valid
bathypora	Genus	electridae	valid
bathystomella	Genus	scorioporidae	valid
batopora	Genus	batoporidae	valid
batoporella	Genus	batoporidae	valid
batrachopora	Genus	cribrilinidae	valid
beania	Genus	beaniidae	valid
beisselina	Genus	tessaradomidae	valid
beisselinopsis	Genus	scorioporidae	valid
bellulopora	Genus	belluloporidae	valid
berthelsenia	Genus	calloporidae	valid
biaviculigera	Genus	calloporidae	valid
bicellariella	Genus	bugulidae	valid
bicellarina	Genus	bugulidae	valid
bicornifera	Genus	bicorniferidae	valid
bicupularia	Genus	batoporidae	valid
bidenkapia	Genus	calloporidae	valid
bifaxaria	Genus	bifaxariidae	valid
bifissurinella	Genus	bicorniferidae	valid
biflustra	Genus	hesychoxeniidae	valid
bimicroporella	Genus	uncertain	valid
bipora	Genus	conescharellinidae	valid
biporochella	Genus	romancheinidae	valid
biselenaria	Genus	cupuladriidae	valid
bitectipora	Genus	bitectiporidae	valid
bobinella	Genus	candidae	valid
boreas	Genus	trypostegidae	valid
boreasina	Genus	trypostegidae	valid
bostrychopora	Genus	romancheinidae	valid
bracebridgia	Genus	adeonidae	valid
brendella	Genus	arachnopusiidae	valid
brettia	Genus	uncertain	valid
brettiella	Genus	bugulidae	valid
brettiopsis	Genus	scrupariidae	valid
briarachnia	Genus	arachnopusiidae	valid
brydonella	Genus	brydonellidae	valid
bryobaculum	Genus	bryobaculidae	valid
bryocalyx	Genus	calloporidae	valid
bryochaperia	Genus	chaperiidae	valid
bryopastor	Genus	bryopastoridae	valid
bryorachis	Genus	phidoloporidae	valid
bryosartor	Genus	catenicellidae	valid
bubnoffiella	Genus	brydonellidae	valid
buchneria	Genus	beisselinidae	valid
buffonellaria	Genus	celleporidae	valid
buffonellodes	Genus	buffonellodidae	valid
bugula	Genus	bugulidae	valid
bugularia	Genus	bugulidae	valid
bugulella	Genus	bugulidae	valid
bugulopsis	Genus	bugulidae	valid
bulbipora	Genus	romancheinidae	valid
bullaconopeum	Genus	electridae	valid
buskea	Genus	celleporidae	valid
caberea	Genus	candidae	valid
cabereopsis	Genus	candidae	valid
caberoides	Genus	catenicellidae	valid
caleschara	Genus	calescharidae	valid
callopora	Genus	calloporidae	valid
calloporina	Genus	labioporellidae	valid
calpensia	Genus	lyroporinae	valid
calpidium	Genus	catenicellidae	valid
calpidopora	Genus	cribrilinidae	valid
calvetina	Genus	duvergieriidae	valid
calvina	Genus	skyloniidae	valid
calwellia	Genus	calwelliidae	valid
calyptooecia	Genus	cleidochasmatidae	valid
calyptotheca	Genus	lanceoporidae	valid
calyptozoum	Genus	bugulidae	valid
camptoplites	Genus	bugulidae	valid
canda	Genus	candidae	valid
candomenipea	Genus	candidae	valid
candoscrupocellaria	Genus	candidae	valid
canupora	Genus	cribrilinidae	valid
carbasea	Genus	flustridae	valid
carydiopora	Genus	cribrilinidae	valid
castanopora	Genus	cribrilinidae	valid
castanoporina	Genus	cribrilinidae	valid
catadysis	Genus	arcanoporidae	valid
catenariopsis	Genus	chaperiidae	valid
catenicella	Genus	catenicellidae	valid
catenicula	Genus	alysidiidae	valid
caulibugula	Genus	bugulidae	valid
caulorhamphus	Genus	calloporidae	valid
cellaria	Genus	cellariidae	valid
cellarinella	Genus	sclerodomidae	valid
cellarinelloides	Genus	sclerodomidae	valid
cellarinidra	Genus	quadricellariidae	valid
cellepora	Genus	celleporidae	valid
celleporina	Genus	celleporidae	valid
ceratopora	Genus	beisselinidae	valid
chalastobugula	Genus	bugulidae	valid
chaperia	Genus	chaperiidae	valid
characodoma	Genus	cleidochasmatidae	valid
charixa	Genus	electridae	valid
chartella	Genus	flustridae	valid
chasmatooecium	Genus	celleporidae	valid
chasmazoon	Genus	celleporidae	valid
chataimulosia	Genus	buffonellodidae	valid
cheethamia	Genus	onychocellidae	valid
cheilhorneropsis	Genus	cheilhorneropsidae	valid
cheilonella	Genus	romancheinidae	valid
cheilopora	Genus	cheiloporinidae	valid
cheiloporina	Genus	cheiloporinidae	valid
chelidozoum	Genus	petalostegidae	valid
chevron	Genus	phidoloporidae	valid
chiastosella	Genus	escharinidae	valid
chiplonkarina	Genus	chiplonkarinidae	valid
chlidonia	Genus	chlidoniidae	valid
chlidoniopsis	Genus	chlidoniopsidae	valid
chondriovelum	Genus	onychocellidae	valid
chorizopora	Genus	chorizoporidae	valid
christinella	Genus	uncertain	valid
chronocerastes	Genus	labioporellidae	valid
cianotremella	Genus	lyroporinae	valid
cigclisula	Genus	colatooeciidae	valid
cillia	Genus	cribrilinidae	valid
claviporella	Genus	catenicellidae	valid
clavodesia	Genus	calloporidae	valid
cleidochasmidra	Genus	cleidochasmatidae	valid
chaperiopsis	Genus	chaperiidae	valid
clithriellum	Genus	lacernidae	valid
coelopora	Genus	cribrilinidae	valid
coleopora	Genus	teuchoporidae	valid
collarina	Genus	cribrilinidae	valid
collura	Genus	onychocellidae	valid
columnella	Genus	farciminariidae	valid
columnotheca	Genus	scorioporidae	valid
concatenella	Genus	concatenellidae	valid
concertina	Genus	calloporidae	valid
conescharellina	Genus	conescharellinidae	valid
conescharellinopsis	Genus	orbituliporidae	valid
confusocella	Genus	cribrilinidae	valid
conopeum	Genus	electridae	valid
cookinella	Genus	fredericellidae	valid
copidozoum	Genus	calloporidae	valid
corbulella	Genus	calloporidae	valid
corbulipora	Genus	cribrilinidae	valid
cornucopina	Genus	bugulidae	valid
cornuticella	Genus	catenicellidae	valid
cornuticellina	Genus	catenicellidae	valid
coronellina	Genus	calescharidae	valid
corymboporella	Genus	cribrilinidae	valid
corynoporella	Genus	bugulidae	valid
corynostylus	Genus	corynostylidae	valid
cosciniopsis	Genus	gigantoporidae	valid
coscinopleura	Genus	coscinopleuridae	valid
costaticella	Genus	catenicellidae	valid
costatimorpha	Genus	catenicellidae	valid
costula	Genus	cribrilinidae	valid
cranosina	Genus	calloporidae	valid
craspedopora	Genus	electridae	valid
craspedoporina	Genus	electridae	valid
crassicellepora	Genus	calloporidae	valid
crassimarginatella	Genus	calloporidae	valid
crateropora	Genus	aspidostomatidae	valid
craticulacella	Genus	cribrilinidae	valid
crepidacantha	Genus	crepidacanthidae	valid
crepis	Genus	chlidoniidae	valid
cribella	Genus	bitectiporidae	valid
cribellopora	Genus	lacernidae	valid
cribralaria	Genus	cribrilinidae	valid
cribrendoecium	Genus	cribrilinidae	valid
cribricellina	Genus	catenicellidae	valid
cribrilina	Genus	cribrilinidae	valid
crucescharellina	Genus	conescharellinidae	valid
crustoporina	Genus	cheiloporinidae	valid
cryptostomaria	Genus	cellariidae	valid
cryptostomella	Genus	beisselinidae	valid
cryptosula	Genus	cryptosulidae	valid
ctenopora	Genus	cribrilinidae	valid
cucullipora	Genus	uncertain	valid
cuneiforma	Genus	bugulidae	valid
cupuladria	Genus	cupuladriidae	valid
curvacella	Genus	quadricellariidae	valid
cuvilliera	Genus	cuvillieridae	valid
cyclicopora	Genus	cyclicoporidae	valid
cyclocolposa	Genus	bryocryptellidae	valid
cycloperiella	Genus	stomachetosellidae	valid
cyclostomella	Genus	uncertain	valid
cylindroporella	Genus	lacernidae	valid
cymulopora	Genus	calloporidae	valid
cyphonella	Genus	porinidae	valid
cystisella	Genus	bryocryptellidae	valid
cyttaridium	Genus	cheiloporinidae	valid
dacryoporella	Genus	hippothoidae	valid
dactylostega	Genus	calloporidae	valid
daisyella	Genus	calloporidae	valid
dakariella	Genus	smittinidae	valid
danocella	Genus	electridae	valid
decurtaria	Genus	cribrilinidae	valid
dendrobeania	Genus	bugulidae	valid
dendroperistoma	Genus	cribrilinidae	valid
dengordonia	Genus	smittinidae	valid
dennisia	Genus	beisselinidae	valid
dentiporella	Genus	phidoloporidae	valid
dermatopora	Genus	calloporidae	valid
desmacystis	Genus	umbonulidae	valid
dhondtiscus	Genus	dhondtiscidae	valid
diacanthopora	Genus	cribrilinidae	valid
diancopora	Genus	cribrilinidae	valid
dibunostoma	Genus	thalamoporellidae	valid
dicasignetella	Genus	uncertain	valid
diceratopora	Genus	cribrilinidae	valid
dictuonia	Genus	onychocellidae	valid
dictyochasma	Genus	phidoloporidae	valid
didymosella	Genus	didymosellidae	valid
didymozoum	Genus	farciminariidae	valid
digenopora	Genus	catenicellidae	valid
dightonia	Genus	escharinidae	valid
dimetopia	Genus	bugulidae	valid
dimorphocella	Genus	adeonidae	valid
dimorphocellaria	Genus	cellariidae	valid
dimorphomicropora	Genus	steginoporellidae	valid
dimorphostylus	Genus	lyroporinae	valid
dionella	Genus	calloporidae	valid
dioptropora	Genus	bryopastoridae	valid
diplobeisselina	Genus	scorioporidae	valid
diplobicellariella	Genus	candidae	valid
diplonotos	Genus	bifaxariidae	valid
diploporella	Genus	thalamoporellidae	valid
diplotresis	Genus	trypostegidae	valid
diporula	Genus	labioporellidae	valid
discoflustrellaria	Genus	columnothecidae	valid
discoporella	Genus	cupuladriidae	valid
discovibracella	Genus	selenariidae	valid
dishelopora	Genus	cribrilinidae	valid
distansescharella	Genus	cribrilinidae	valid
disteginopora	Genus	cribrilinidae	valid
distelopora	Genus	calloporidae	valid
ditaxipora	Genus	catenicellidae	valid
ditaxiporina	Genus	catenicellidae	valid
dittomesia	Genus	smittinidae	valid
dittosaria	Genus	pasytheidae	valid
domosclerus	Genus	bifaxariidae	valid
doryporella	Genus	doryporellidae	valid
doryporellina	Genus	doryporellidae	valid
drepanophora	Genus	beisselinidae	valid
dubiocellaria	Genus	cellariidae	valid
duvergieria	Genus	duvergieriidae	valid
dysnoetocella	Genus	uncertain	valid
dysnoetopora	Genus	dysnoetoporidae	valid
echinovadoma	Genus	echinovadomidae	valid
electra	Genus	electridae	valid
ellisina	Genus	calloporidae	valid
emballotheca	Genus	lanceoporidae	valid
eminooecia	Genus	eminooeciidae	valid
emma	Genus	candidae	valid
encicellaria	Genus	fusicellariidae	valid
enoplostomella	Genus	schizoporellidae	valid
entomaria	Genus	aspidostomatidae	valid
eohippothoa	Genus	trypostegidae	valid
eokotosokum	Genus	electridae	valid
eoscrupocellaria	Genus	candidae	valid
epistomia	Genus	epistomiidae	valid
erinella	Genus	cellariidae	valid
escharella	Genus	romancheinidae	valid
escharicellaria	Genus	cellariidae	valid
escharifora	Genus	coscinopleuridae	valid
escharina	Genus	escharinidae	valid
escharipora	Genus	lyroporinae	valid
escharoides	Genus	romancheinidae	valid
escharopsis	Genus	umbonulidae	valid
eucheilopora	Genus	cribrilinidae	valid
eucratea	Genus	eucrateidae	valid
euginoma	Genus	cellariidae	valid
euoplozoum	Genus	euoplozoidae	valid
eupaxia	Genus	candidae	valid
euritina	Genus	onychocellidae	valid
eurystomella	Genus	eurystomellidae	valid
eutaleia	Genus	pasytheidae	valid
euthyrisella	Genus	euthyrisellidae	valid
euthyroides	Genus	euthyroididae	valid
exallozoon	Genus	chaperiidae	valid
exechonella	Genus	exechonellidae	valid
exochella	Genus	romancheinidae	valid
exostesia	Genus	chaperiidae	valid
falsibugulella	Genus	bugulidae	valid
farciminaria	Genus	farciminariidae	valid
farciminellopsis	Genus	bugulidae	valid
farciminellum	Genus	farciminariidae	valid
fatkullina	Genus	stomachetosellidae	valid
fedora	Genus	ascosiidae	valid
fedorella	Genus	cleidochasmatidae	valid
fenestrulina	Genus	labioporellidae	valid
fenestruloides	Genus	labioporellidae	valid
ferganula	Genus	schizoporellidae	valid
figularia	Genus	cribrilinidae	valid
filaguria	Genus	cribrilinidae	valid
filiflustrina	Genus	calloporidae	valid
fissuricella	Genus	uncertain	valid
flabellopora	Genus	conescharellinidae	valid
floridina	Genus	onychocellidae	valid
floridinella	Genus	onychocellidae	valid
flustra	Genus	flustridae	valid
flustramorpha	Genus	labioporellidae	valid
flustrapora	Genus	lyroporinae	valid
flustrellaria	Genus	calloporidae	valid
fodinella	Genus	phidoloporidae	valid
formosocellaria	Genus	cellariidae	valid
foveolaria	Genus	foveolariidae	valid
francopora	Genus	cribrilinidae	valid
frurionella	Genus	beisselinidae	valid
fusicellaria	Genus	fusicellariidae	valid
galeopsis	Genus	celleporidae	valid
gargantua	Genus	lyroporinae	valid
gastropella	Genus	porinidae	valid
gaudryanella	Genus	steginoporellidae	valid
geisopora	Genus	cribrilinidae	valid
gemellipora	Genus	pasytheidae	valid
gemelliporella	Genus	gemelliporellidae	valid
gemelliporidra	Genus	schizoporellidae	valid
gemelliporina	Genus		valid
geminella	Genus	catenicellidae	valid
gephyrophora	Genus	gigantoporidae	valid
gephyrotes	Genus	cribrilinidae	valid
gigantopora	Genus	gigantoporidae	valid
gilbertopora	Genus	calloporidae	valid
glenelgia	Genus	calloporidae	valid
gontarella	Genus	electridae	valid
goodonia	Genus	uncertain	valid
gordoniella	Genus	cribrilinidae	valid
grammothoa	Genus	trypostegidae	valid
graptoporella	Genus	cribrilinidae	valid
gregarinidra	Genus	flustridae	valid
hagenowinella	Genus	calescharidae	valid
hagiosynodos	Genus	cheiloporinidae	valid
halysisis	Genus	savignyellidae	valid
haplocephalopora	Genus	cribrilinidae	valid
haplopoma	Genus	haplopomidae	valid
haplota	Genus	hippothoidae	valid
hapsidopora	Genus	calloporidae	valid
harmeria	Genus	cryptosulidae	valid
harpago	Genus	arcanoporidae	valid
harpecia	Genus	electridae	valid
haswelliporina	Genus	porinidae	valid
hayamiellina	Genus	cribrilinidae	valid
heliodoma	Genus	heliodomidae	valid
helixotionella	Genus	otionellidae	valid
hellerasca	Genus	romancheinidae	valid
hemicosciniopsis	Genus	gigantoporidae	valid
hemicyclopora	Genus	romancheinidae	valid
hemiphylactella	Genus	romancheinidae	valid
hemiseptella	Genus	calloporidae	valid
hemismittoidea	Genus	smittinidae	valid
hemistylus	Genus	cellariidae	valid
henrimilnella	Genus	cellariidae	valid
herpetopora	Genus	electridae	valid
hesperopora	Genus	cribrilinidae	valid
hesychoxenia	Genus	thalamoporellidae	valid
heteractis	Genus	columnothecidae	valid
heteroconopeum	Genus	chiplonkarinidae	valid
heterooecium	Genus	tendridae	valid
hexacanthopora	Genus	cribrilinidae	valid
hiantopora	Genus	hiantoporidae	valid
himantozoumella	Genus	bugulidae	valid
hincksina	Genus	flustridae	valid
hincksinoflustra	Genus	flustridae	valid
hincksipora	Genus	hincksiporidae	valid
hippadenella	Genus	uncertain	valid
hippaliosina	Genus	hippaliosinidae	valid
hippellozoon	Genus	phidoloporidae	valid
hippiopora	Genus	cribrilinidae	valid
hippolyrula	Genus	romancheinidae	valid
hippomenella	Genus	escharinidae	valid
hippomonavella	Genus	bitectiporidae	valid
hippophylactella	Genus	smittinidae	valid
hippopleurifera	Genus	romancheinidae	valid
hippopodina	Genus	hippopodinidae	valid
hippoporella	Genus	hippoporidridae	valid
hippoporidra	Genus	hippoporidridae	valid
hippoporina	Genus	bitectiporidae	valid
hippopozoon	Genus	phidoloporidae	valid
hipposera	Genus	schizoporellidae	valid
hippothoa	Genus	hippothoidae	valid
hippothyris	Genus	bitectiporidae	valid
hippotrema	Genus	hippoporidridae	valid
hoeverella	Genus	uncertain	valid
holostegopora	Genus	cribrilinidae	valid
holsacella	Genus	onychocellidae	valid
homalostega	Genus	brydonellidae	valid
hoplitaechmella	Genus	lyroporinae	valid
hoplitella	Genus	candidae	valid
hoplocheilina	Genus	romancheinidae	valid
houzeauina	Genus	smittinidae	valid
hybopora	Genus	cribrilinidae	valid
hystricopora	Genus	cribrilinidae	valid
icelozoon	Genus	chaperiidae	valid
ichnopora	Genus	cribrilinidae	valid
ichthyaria	Genus	calwelliidae	valid
ijimaia	Genus	calwelliidae	valid
integripelta	Genus	eurystomellidae	valid
inversaria	Genus	onychocellidae	valid
inversiscaphos	Genus	cribrilinidae	valid
inversiula	Genus	inversiulidae	valid
iodictyum	Genus	phidoloporidae	valid
ipsibuffonella	Genus	buffonellodidae	valid
isoschizoporella	Genus	eminooeciidae	valid
isoseculiflustra	Genus	flustridae	valid
jaculina	Genus	jaculinidae	valid
jellyella	Genus	hesychoxeniidae	valid
jolietina	Genus	cribrilinidae	valid
jubella	Genus	jubellidae	valid
jugescharellina	Genus	arcanoporidae	valid
julianca	Genus	uncertain	valid
jullienula	Genus	cribrilinidae	valid
kankopora	Genus	cribrilinidae	valid
kausiaria	Genus	otionellidae	valid
kelestoma	Genus	cribrilinidae	valid
kenella	Genus	flustridae	valid
keratostoma	Genus	cribrilinidae	valid
kinetoskias	Genus	bugulidae	valid
kionidella	Genus	ascosiidae	valid
kladapheles	Genus	beisselinidae	valid
kleidionella	Genus	beisselinidae	valid
klugeflustra	Genus	uncertain	valid
klugella	Genus	bugulidae	valid
klugerella	Genus	cribrilinidae	valid
kronothoa	Genus	trypostegidae	valid
kubaninella	Genus	adeonidae	valid
kunradina	Genus	trypostegidae	valid
kunradocella	Genus	calloporidae	valid
kylonisa	Genus	skyloniidae	valid
kymella	Genus	uncertain	valid
labioporella	Genus	steginoporellidae	valid
lacerna	Genus	lacernidae	valid
lacrimula	Genus	batoporidae	valid
lagarozoum	Genus	aspidostomatidae	valid
lageneschara	Genus	romancheinidae	valid
lagenicella	Genus	teuchoporidae	valid
lagenipora	Genus	celleporidae	valid
lagynopora	Genus	cribrilinidae	valid
laminopora	Genus	adeonellidae	valid
lamourouxia	Genus	calloporidae	valid
lanceopora	Genus	lanceoporidae	valid
larnacicus	Genus	chaperiidae	valid
larvapora	Genus	aspidostomatidae	valid
latereschara	Genus	onychocellidae	valid
lateroflustrella	Genus	antroporidae	valid
lateroflustrellaria	Genus	uncertain	valid
laterotecatia	Genus	hippothoidae	valid
leieschara	Genus		valid
leiosalpinx	Genus	acoraniidae	valid
leiosella	Genus	beisselinidae	valid
lekythoglena	Genus	actinoporidae	valid
lekythopora	Genus	arcanoporidae	valid
lepraliella	Genus	beisselinidae	valid
lepralina	Genus	cribrilinidae	valid
lepralioides	Genus	stomachetosellidae	valid
leptinatella	Genus	calloporidae	valid
leptocheilopora	Genus	cribrilinidae	valid
lifuella	Genus	phidoloporidae	valid
luganella	Genus	columnothecidae	valid
luguba	Genus	bugulidae	valid
lunularia	Genus	bicellariellidae	valid
lunulites	Genus	columnothecidae	valid
macrocamera	Genus	eminooeciidae	valid
macropora	Genus	cristatellidae	valid
macroporella	Genus	cristatellidae	valid
macroporina	Genus	cristatellidae	valid
maiabuffonella	Genus	buffonellodidae	valid
malakosaria	Genus	calwelliidae	valid
malleatia	Genus	phidoloporidae	valid
mamillopora	Genus	ditaxiporinidae	valid
manzonella	Genus	lyroporinae	valid
maplestonia	Genus	candidae	valid
margaretta	Genus	exochellidae	valid
marginaria	Genus	calloporidae	valid
marguetta	Genus	bryocryptellidae	valid
marssonopora	Genus	calloporidae	valid
marsupioporella	Genus	thalamoporellidae	valid
matyashegyella	Genus	onychocellidae	valid
mawatarius	Genus	flabellotrypidae	valid
mediosola	Genus	quadricellariidae	valid
megapora	Genus	calloporidae	valid
melicerita	Genus	cellariidae	valid
melychocella	Genus	cellariidae	valid
membranicellaria	Genus	fredericellidae	valid
membranipora	Genus	hesychoxeniidae	valid
membraniporella	Genus	cribrilinidae	valid
membraniporidra	Genus	calloporidae	valid
membraniporopsis	Genus	flustridae	valid
menipea	Genus	candidae	valid
meniscopora	Genus	adeonidae	valid
mesostomaria	Genus	cellariidae	valid
metacleidochasma	Genus	phidoloporidae	valid
metracolposa	Genus	cribrilinidae	valid
metradolium	Genus	stomachetosellidae	valid
metrarabdotomorpha	Genus	romancheinidae	valid
metrocrypta	Genus	stomachetosellidae	valid
metroperiella	Genus	bitectiporidae	valid
micropora	Genus	lyroporinae	valid
microporella	Genus	labioporellidae	valid
microporelloides	Genus	labioporellidae	valid
microporina	Genus	lyroporinae	valid
mixtopelta	Genus	nematoporellidae	valid
mobunula	Genus	petraliellidae	valid
mollia	Genus	lyroporinae	valid
monartron	Genus	candidae	valid
monoceratopora	Genus	cribrilinidae	valid
monoporella	Genus	palescharidae	valid
monsella	Genus	lyroporinae	valid
monticellaria	Genus	bryopastoridae	valid
morphasmopora	Genus	cribrilinidae	valid
mosaicoporina	Genus	porinidae	valid
mosathoa	Genus	trypostegidae	valid
mucropetraliella	Genus	petraliellidae	valid
multescharellina	Genus	beisselinidae	valid
multescharipora	Genus	cribrilinidae	valid
mumiella	Genus	cribrilinidae	valid
murinopsia	Genus	cribrilinidae	valid
myagropora	Genus	cribrilinidae	valid
mychoplectra	Genus	electridae	valid
myriapora	Genus		valid
myriozoella	Genus		valid
mystriopora	Genus	calloporidae	valid
nannopora	Genus	cribrilinidae	valid
nellia	Genus	quadricellariidae	valid
nelliella	Genus	quadricellariidae	valid
nematoflustra	Genus	flustridae	valid
nematoporella	Genus	lyroporinae	valid
neodakaria	Genus	bitectiporidae	valid
neoeuthyris	Genus	uncertain	valid
neoflustra	Genus	uncertain	valid
neolagenipora	Genus	romancheinidae	valid
celleporella	Genus	hippothoidae	valid
nephropora	Genus	nephroporidae	valid
nimba	Genus	lacernidae	valid
nimbella	Genus	lacernidae	valid
nordgaardia	Genus	bugulidae	valid
notocoryne	Genus	chaperiidae	valid
notoplites	Genus	candidae	valid
notoplitesigia	Genus	candidae	valid
nudicella	Genus	onychocellidae	valid
nudonychocella	Genus	onychocellidae	valid
obliquostoma	Genus	romancheinidae	valid
ochetosella	Genus	romancheinidae	valid
ochetosellina	Genus	uncertain	valid
odontionella	Genus	foveolariidae	valid
odontoporella	Genus	hippoporidridae	valid
ogiva	Genus	onychocellidae	valid
ogivalia	Genus	uncertain	valid
ogivalina	Genus	calloporidae	valid
oligotopora	Genus	cribrilinidae	valid
oligotresium	Genus	columnothecidae	valid
omalosecosa	Genus	celleporidae	valid
onchoporella	Genus	calwelliidae	valid
onchoporoides	Genus	calwelliidae	valid
onychoblestrum	Genus	calloporidae	valid
onychocella	Genus	onychocellidae	valid
onychocellaria	Genus	onychocellidae	valid
opaeomorpha	Genus	romancheinidae	valid
opaeophora	Genus	lyroporinae	valid
opisthornithopora	Genus	cribrilinidae	valid
oppiphorina	Genus	phorioppniidae	valid
orbitulipora	Genus	orbituliporidae	valid
ornatella	Genus	calloporidae	valid
orthoporidra	Genus	arcanoporidae	valid
orthoporidroides	Genus	celleporidae	valid
orthoscuticella	Genus	catenicellidae	valid
osthimosia	Genus	celleporidae	valid
otiochmella	Genus	onychocellidae	valid
otionella	Genus	otionellidae	valid
otionellina	Genus	otionellidae	valid
otopora	Genus	cribrilinidae	valid
ovaticella	Genus	adeonidae	valid
pachybaktropora	Genus	calloporidae	valid
pachycleithonia	Genus	watersiporidae	valid
pachydera	Genus	cribrilinidae	valid
pachydermopora	Genus	tessaradomidae	valid
pachyegis	Genus	stomachetosellidae	valid
pachykraspedon	Genus	romancheinidae	valid
pachystomaria	Genus	cheiloporinidae	valid
pachythecella	Genus	tessaradomidae	valid
pacificincola	Genus	pacificincolidae	valid
palmicellaria	Genus	celleporidae	valid
palmiskenea	Genus	bryocryptellidae	valid
pancheilopora	Genus	cribrilinidae	valid
paracatenicula	Genus	alysidiidae	valid
paracellaria	Genus	cellariidae	valid
paracribricellina	Genus	catenicellidae	valid
parafigularia	Genus	cribrilinidae	valid
parantropora	Genus	antroporidae	valid
parasmittina	Genus	smittinidae	valid
parastichopora	Genus	uncertain	valid
parellisina	Genus	calloporidae	valid
parkermavella	Genus	bitectiporidae	valid
pasythea	Genus	pasytheidae	valid
patsyella	Genus	chaperiidae	valid
pavobeisselina	Genus	tessaradomidae	valid
pavolunulites	Genus	columnothecidae	valid
pelmatopora	Genus	cribrilinidae	valid
pemmatoporella	Genus	smittinidae	valid
penemia	Genus	candidae	valid
pentapora	Genus	bitectiporidae	valid
periporosella	Genus	calloporidae	valid
petalostegus	Genus	petalostegidae	valid
petasosella	Genus	otionellidae	valid
petralia	Genus	petraliidae	valid
petraliella	Genus	petraliellidae	valid
phaeostachys	Genus	escharinidae	valid
phidolopora	Genus	phidoloporidae	valid
phoceana	Genus	phoceanidae	valid
phonicosia	Genus	lacernidae	valid
phorioppnia	Genus	phorioppniidae	valid
phractoporella	Genus	cribrilinidae	valid
phrynopora	Genus	cribrilinidae	valid
phylactella	Genus	smittinidae	valid
phylactellina	Genus	smittinidae	valid
pithodella	Genus	calloporidae	valid
plagiopora	Genus	catenicellidae	valid
plagiosmittia	Genus	smittinidae	valid
planicellaria	Genus	calloporidae	valid
platychelyna	Genus	smittinidae	valid
platyglena	Genus	platyglenidae	valid
plesiocleidochasma	Genus	phidoloporidae	valid
plesiothoa	Genus	hippothoidae	valid
pleurocodonellina	Genus	smittinidae	valid
pleurolyrula	Genus	romancheinidae	valid
pleuromucrum	Genus	romancheinidae	valid
pleuroschizella	Genus	cribrilinidae	valid
pleurotoichus	Genus	euthyrisellidae	valid
pliophloea	Genus	cribrilinidae	valid
pnictopora	Genus	cribrilinidae	valid
pnictoporopsis	Genus	platyglenidae	valid
poecilopora	Genus	arcanoporidae	valid
polirhabdotos	Genus	kielceporidae	valid
pollicipora	Genus	polliciporidae	valid
polycephalopora	Genus	cribrilinidae	valid
polyceratopora	Genus	cribrilinidae	valid
porella	Genus	bryocryptellidae	valid
poricella	Genus	arachnopusiidae	valid
poricellaria	Genus	poricellariidae	valid
porina	Genus	porinidae	valid
porismittina	Genus	smittinidae	valid
poristoma	Genus	adeonidae	valid
porometra	Genus	kielceporidae	valid
poropeltarion	Genus	lyroporinae	valid
posterula	Genus	umbonulidae	valid
prattia	Genus	uncertain	valid
prenantia	Genus	smittinidae	valid
prodromopora	Genus	cribrilinidae	valid
promicroa	Genus	lyroporinae	valid
prosotopora	Genus	cribrilinidae	valid
prostomaria	Genus	prostomariidae	valid
pseudoadelascopora	Genus	labioporellidae	valid
pseudobathystomella	Genus	tessaradomidae	valid
pseudobeisselina	Genus	beisselinidae	valid
pseudocelleporina	Genus	celleporidae	valid
pseudoflustra	Genus	smittinidae	valid
pseudolepralia	Genus	pseudolepraliidae	valid
pseudolunularia	Genus	selenariidae	valid
pseudolunulites	Genus	onychocellidae	valid
pseudoplatyglena	Genus	euthyrisellidae	valid
pseudoporicellaria	Genus	candidae	valid
pseudosclerodomus	Genus	romancheinidae	valid
pseudostega	Genus	uncertain	valid
pseudothyracella	Genus	bryopastoridae	valid
psileschara	Genus	phidoloporidae	valid
psilopsella	Genus	romancheinidae	valid
psilosecos	Genus	phidoloporidae	valid
pterocella	Genus	catenicellidae	valid
ptoboroa	Genus	conescharellinidae	valid
puellina	Genus	cribrilinidae	valid
punctiscutella	Genus	phorioppniidae	valid
punctocellaria	Genus	calloporidae	valid
puncturiella	Genus	lyroporinae	valid
pyrichaperia	Genus	chaperiidae	valid
pyriflustrina	Genus	calloporidae	valid
pyripora	Genus	electridae	valid
pyriporella	Genus	calloporidae	valid
pyriporoides	Genus	calloporidae	valid
pyriporopsis	Genus	electridae	valid
quadricellaria	Genus	quadricellariidae	valid
quadriscutella	Genus	phorioppniidae	valid
radulopora	Genus	onychocellidae	valid
ragionula	Genus	romancheinidae	valid
ralepria	Genus	lacernidae	valid
ramicosticella	Genus	arachnopusiidae	valid
ramphonotus	Genus	calloporidae	valid
raxifabia	Genus	bifaxariidae	valid
raymondcia	Genus	smittinidae	valid
reciprocus	Genus	uncertain	valid
rectonychocella	Genus	onychocellidae	valid
rectoporina	Genus	trypostegidae	valid
reginella	Genus	cribrilinidae	valid
reginelloides	Genus	cribrilinidae	valid
reptadeonella	Genus	adeonidae	valid
reptescharella	Genus	cribrilinidae	valid
reptescharinella	Genus	aspidostomatidae	valid
reptescharipora	Genus	cribrilinidae	valid
reptoflustrella	Genus	calloporidae	valid
reptolunulites	Genus	onychocellidae	valid
reptoporella	Genus	cribrilinidae	valid
reptoporina	Genus	calloporidae	valid
retelepralia	Genus	cheiloporinidae	valid
reteporella	Genus	phidoloporidae	valid
reteporellina	Genus	phidoloporidae	valid
retevirgula	Genus	calloporidae	valid
retiflustra	Genus	flustridae	valid
reussia	Genus	bryocryptellidae	valid
reussirella	Genus	cupuladriidae	valid
rhabdopora	Genus	cribrilinidae	valid
rhabdotometra	Genus	kielceporidae	valid
rhabdozoum	Genus	rhabdozoidae	valid
rhacheopora	Genus	cribrilinidae	valid
rhamphosmittina	Genus	bryocryptellidae	valid
rhamphostomella	Genus	umbonulidae	valid
rhebasia	Genus	onychocellidae	valid
rhiniopora	Genus	cribrilinidae	valid
rhynchozoon	Genus	phidoloporidae	valid
richbunea	Genus	celleporidae	valid
rimosocella	Genus	lyroporinae	valid
rimulostoma	Genus	smittinidae	valid
riscodopa	Genus	petraliellidae	valid
robertsonidra	Genus	uncertain	valid
rogicka	Genus	lacernidae	valid
romancheina	Genus	romancheinidae	valid
rosseliana	Genus	antroporidae	valid
rotiporina	Genus	scorioporidae	valid
saevitella	Genus	hippopodinidae	valid
samudraka	Genus	antroporidae	valid
sandalopora	Genus	cribrilinidae	valid
sarsiflustra	Genus	flustridae	valid
savignyella	Genus	savignyellidae	valid
scalicella	Genus	catenicellidae	valid
schedocleidochasma	Genus	phidoloporidae	valid
schismoporella	Genus	smittinidae	valid
schistacanthopora	Genus	cribrilinidae	valid
schizaropsis	Genus	lacernidae	valid
schizemiella	Genus	stomachetosellidae	valid
schizemiellopsis	Genus	beisselinidae	valid
schizobathysella	Genus	escharinidae	valid
schizobrachiella	Genus	schizoporellidae	valid
schizolepralia	Genus	schizoporellidae	valid
schizomavella	Genus	bitectiporidae	valid
schizoporella	Genus	schizoporellidae	valid
schizoporellopsis	Genus	uncertain	valid
schizoretepora	Genus	phidoloporidae	valid
schizorthosecos	Genus	uncertain	valid
schizosmittina	Genus	bitectiporidae	valid
schizostomella	Genus	adeonidae	valid
schizotheca	Genus	phidoloporidae	valid
schizotremopora	Genus	duvergieriidae	valid
sclerodomus	Genus	sclerodomidae	valid
scoriopora	Genus	scorioporidae	valid
scorpiodina	Genus	umbonulidae	valid
scorpiodinipora	Genus	celleporidae	valid
scruparia	Genus	scrupariidae	valid
scrupocellaria	Genus	candidae	valid
scrupocellarinella	Genus	candidae	valid
scuticella	Genus	catenicellidae	valid
securiflustra	Genus	flustridae	valid
selenaria	Genus	selenariidae	valid
selenariopsis	Genus	eurystomellidae	valid
semibugula	Genus	candidae	valid
semidendrobeania	Genus	bugulidae	valid
semieschara	Genus	onychocellidae	valid
semiescharinella	Genus	aspidostomatidae	valid
semiescharipora	Genus	cribrilinidae	valid
semiflustrella	Genus	calloporidae	valid
semiflustrina	Genus	calloporidae	valid
semihaswellia	Genus	porinidae	valid
semikinetoskias	Genus	bugulidae	valid
serratiflustra	Genus	flustridae	valid
sertulipora	Genus	phoceanidae	valid
sessibugula	Genus	bugulidae	valid
setosella	Genus	setosellidae	valid
setosellina	Genus	heliodomidae	valid
setosinella	Genus	lyroporinae	valid
bryocryptella	Genus	bryocryptellidae	valid
sinoflustra	Genus	flustridae	valid
sinupetraliella	Genus	petraliellidae	valid
celleporaria	Genus	beisselinidae	valid
siphonicytara	Genus	siphonicytaridae	valid
siphonoporella	Genus	steginoporellidae	valid
skylonia	Genus	skyloniidae	valid
smithsonius	Genus	bifaxariidae	valid
smitticellaria	Genus	cellariidae	valid
smittina	Genus	smittinidae	valid
smittinella	Genus	smittinidae	valid
smittipora	Genus	onychocellidae	valid
smittistoma	Genus	adeonidae	valid
smittoidea	Genus	smittinidae	valid
solenonychocella	Genus	onychocellidae	valid
solenophragma	Genus	calloporidae	valid
sparsiporina	Genus	phidoloporidae	valid
sphaeropora	Genus	beisselinidae	valid
sphaerulobryozoon	Genus	orbituliporidae	valid
sphenella	Genus	sfeniellidae	valid
spigaleos	Genus	celleporidae	valid
spinicharixa	Genus	electridae	valid
spiralaria	Genus	flustridae	valid
stamenocella	Genus	calloporidae	valid
staurosteginopora	Genus	arachnopusiidae	valid
steginocellaria	Genus	cellariidae	valid
steginopora	Genus	cribrilinidae	valid
steginoporella	Genus	steginoporellidae	valid
stenosipora	Genus	ascosiidae	valid
stenostomaria	Genus	catenicellidae	valid
stephanollona	Genus	phidoloporidae	valid
stephanopora	Genus	exechonellidae	valid
stephanotrema	Genus	stomachetosellidae	valid
steraechmella	Genus	lyroporinae	valid
stichocados	Genus	cribrilinidae	valid
stichomicropora	Genus	lyroporinae	valid
stichopora	Genus	uncertain	valid
stichoporina	Genus	batoporidae	valid
stictostega	Genus	lyroporinae	valid
stolonella	Genus	beaniidae	valid
stomachetosella	Genus	stomachetosellidae	valid
stomhypselosaria	Genus	cellariidae	valid
strongylopora	Genus	catenicellidae	valid
strophiella	Genus	phidoloporidae	valid
strophipora	Genus	catenicellidae	valid
stylopoma	Genus	schizoporellidae	valid
swanomia	Genus	cellariidae	valid
sylonika	Genus	skyloniidae	valid
synaptacella	Genus	candidae	valid
synnotum	Genus	epistomiidae	valid
syringotrema	Genus	cellariidae	valid
systenopora	Genus	sclerodomidae	valid
systenostoma	Genus	platyglenidae	valid
taeniocellaria	Genus	uncertain	valid
taenioporella	Genus	uncertain	valid
taenioporina	Genus	uncertain	valid
talivittaticella	Genus	catenicellidae	valid
taphrostoma	Genus	aspidostomatidae	valid
taractopora	Genus	cribrilinidae	valid
tecatia	Genus	pasytheidae	valid
tegella	Genus	calloporidae	valid
tegminula	Genus	celleporidae	valid
teichopora	Genus	adeonidae	valid
temachia	Genus	romancheinidae	valid
tendra	Genus	tendridae	valid
tenthrenulina	Genus	labioporellidae	valid
terataulopocella	Genus	arcanoporidae	valid
terminocella	Genus	catenicellidae	valid
terminoflustra	Genus	flustridae	valid
tessaradoma	Genus	tessaradomidae	valid
tetraplaria	Genus	tetraplariidae	valid
teuchopora	Genus	teuchoporidae	valid
thairopora	Genus	thalamoporellidae	valid
thalamoporella	Genus	thalamoporellidae	valid
himantozoum	Genus	bugulidae	valid
therenia	Genus	escharinidae	valid
thoracopora	Genus	cribrilinidae	valid
thornelya	Genus	hippopodinidae	valid
thrypticocirrus	Genus	smittinidae	valid
thyracella	Genus	bryopastoridae	valid
toretocheilum	Genus	escharinidae	valid
tornipora	Genus	onychocellidae	valid
torquatella	Genus	torquatellidae	valid
tracheloptyx	Genus	smittinidae	valid
trematooecia	Genus	colatooeciidae	valid
tremocoscinopleura	Genus	coscinopleuridae	valid
tremogasterina	Genus	calloporidae	valid
tremopora	Genus	hiantoporidae	valid
tremoschizodina	Genus	stomachetosellidae	valid
tremotoichus	Genus	porinidae	valid
treptopora	Genus	calloporidae	valid
tretosina	Genus	calescharidae	valid
tricellaria	Genus	candidae	valid
tricephalopora	Genus	cribrilinidae	valid
trichinopolia	Genus	arachnopusiidae	valid
tricolpopora	Genus	trypostegidae	valid
trigonopora	Genus	umbonulidae	valid
trilaminopora	Genus	arachnopusiidae	valid
trilochites	Genus	hippopodinidae	valid
trilophopora	Genus	trypostegidae	valid
triphyllozoon	Genus	phidoloporidae	valid
triporula	Genus	adeonidae	valid
trochosodon	Genus	conescharellinidae	valid
tropidozoum	Genus	euthyrisellidae	valid
trypocella	Genus	adeonidae	valid
trypostega	Genus	trypostegidae	valid
tshokrakopora	Genus	uncertain	valid
tubescharina	Genus	uncertain	valid
tubiporella	Genus	didymosellidae	valid
tubucella	Genus	exochellidae	valid
turbicellepora	Genus	celleporidae	valid
turritigera	Genus	arcanoporidae	valid
tychinella	Genus	tetraplariidae	valid
tylopora	Genus	calloporidae	valid
tyloporella	Genus	calloporidae	valid
ubaghsia	Genus	cribrilinidae	valid
umbonula	Genus	umbonulidae	valid
metrarabdotos	Genus	kielceporidae	valid
unidistelopora	Genus	calloporidae	valid
unifissurinella	Genus	pasytheidae	valid
urceolipora	Genus	uncertain	valid
uschakovia	Genus	bugulidae	valid
uscia	Genus	watersiporidae	valid
utinga	Genus	petraliellidae	valid
valdemunitella	Genus	calloporidae	valid
vasignyella	Genus	catenicellidae	valid
vavropora	Genus	cribrilinidae	valid
veleroa	Genus	watersiporidae	valid
verminaria	Genus	lyroporinae	valid
vibracella	Genus	uncertain	valid
vibracellina	Genus	cupuladriidae	valid
vibraculina	Genus	uncertain	valid
vicariopora	Genus	cribrilinidae	valid
villicharixa	Genus	electridae	valid
vincularia	Genus	calvetiidae	valid
vincularina	Genus	quadricellariidae	valid
virgocella	Genus	onychocellidae	valid
vitrius	Genus	lacernidae	valid
vix	Genus	uncertain	valid
volviflustrellaria	Genus	uncertain	valid
voorthuyseniella	Genus	bicorniferidae	valid
watersipora	Genus	watersiporidae	valid
wawalia	Genus	wawaliidae	valid
wilbertopora	Genus	calloporidae	valid
woodipora	Genus	onychocellidae	valid
wrigiana	Genus	calwelliidae	valid
xaveropora	Genus	batoporidae	valid
xylochotridens	Genus	calloporidae	valid
xynexecha	Genus	exechonellidae	valid
yrbozoon	Genus	cleidochasmatidae	valid
zeuglopora	Genus	conescharellinidae	valid
zuzanella	Genus	smittinidae	valid
zygopalme	Genus	eurystomellidae	valid
halophila	Genus	bugulidae	valid
parmularia	Genus	lanceoporidae	valid
amphimarssoniella	Genus	corymboporidae	valid
anguisia	Genus	oncousoeciidae	valid
annectocyma	Genus	annectocymidae	valid
apatotervia	Genus	uncertain	valid
apsendesia	Genus	frondiporidae	valid
asatkinella	Genus	diastoporidae	valid
atagma	Genus	eleidae	valid
attinopora	Genus	cinctiporidae	valid
bathysoecia	Genus	tubuliporidae	valid
bicavea	Genus	cytididae	valid
bicoronipora	Genus	entalophoridae	valid
bicrisia	Genus	crisiidae	valid
bicrisina	Genus	crisinidae	valid
bientalophora	Genus	pustuloporidae	valid
biflabellaria	Genus	cerioporidae	valid
biforicula	Genus	eleidae	valid
biidmonea	Genus	crisinidae	valid
bimulticavea	Genus	lichenoporidae	valid
biovicella	Genus	tubuliporidae	valid
biretepora	Genus	crisinidae	valid
bisidmonea	Genus	entalophoridae	valid
bitubigera	Genus	crisinidae	valid
blumenbachium	Genus	cerioporidae	valid
bobiesipora	Genus	uncertain	valid
borgella	Genus	cerioporidae	valid
borgiola	Genus	cerioporidae	valid
brachysoecia	Genus	entalophoridae	valid
braiesopora	Genus	uncertain	valid
bueltenopora	Genus	uncertain	valid
buglovella	Genus	tubuliporidae	valid
actinopora	Genus	theonoidae	valid
buskia	Genus	buskiidae	valid
calvetia	Genus	calvetiidae	valid
canalipora	Genus	canaliporidae	valid
cardioecia	Genus	diastoporidae	valid
castellia	Genus	idmoneidae	valid
cava	Genus	cavidae	valid
cavaria	Genus	plagioeciidae	valid
cavarinella	Genus	petaloporidae	valid
ceata	Genus	plagioeciidae	valid
cellulipora	Genus	celluliporidae	valid
centronea	Genus	crisinidae	valid
ceriocava	Genus	cavidae	valid
ceriopora	Genus	cerioporidae	valid
cerioporella	Genus	uncertain	valid
chaotianopora	Genus	uncertain	valid
chartecytis	Genus	cytididae	valid
choristopetalum	Genus	petaloporidae	valid
cinctipora	Genus	cinctiporidae	valid
circibipora	Genus	plagioeciidae	valid
clausa	Genus	clausidae	valid
clavicava	Genus	crisinidae	valid
clavisparsa	Genus	entalophoridae	valid
clavitubigera	Genus	crisinidae	valid
clinopora	Genus	uncertain	valid
clonopora	Genus	crownoporidae	valid
clypeina	Genus	entalophoridae	valid
coelocochlea	Genus	petaloporidae	valid
coelospiropora	Genus	uncertain	valid
collapora	Genus	multisparsidae	valid
conocavea	Genus	lichenoporidae	valid
conotubigera	Genus	theonoidae	valid
constrictopora	Genus	frondiporidae	valid
coronidmonea	Genus	tubuliporidae	valid
coronopora	Genus	lichenoporidae	valid
corymbopora	Genus	corymboporidae	valid
corynotrypa	Genus	corynotrypidae	valid
corynotrypoides	Genus	uncertain	valid
coscinoecia	Genus	cerioporidae	valid
crassodiscopora	Genus	crassodiscoporidae	valid
crassohornera	Genus	horneridae	valid
crescis	Genus	cerioporidae	valid
crisevia	Genus	crisiidae	valid
crisia	Genus	crisiidae	valid
crisidia	Genus	crisiidae	valid
crisidmonea	Genus	crisinidae	valid
crisiella	Genus	crisiidae	valid
crisina	Genus	crisinidae	valid
crisiona	Genus	crisiidae	valid
crisisina	Genus	tubuliporidae	valid
crisulipora	Genus	crisuliporidae	valid
cryptoglena	Genus	cerioporidae	valid
cuffeyella	Genus	crownoporidae	valid
cylindropora	Genus	cinctiporidae	valid
cyrtopora	Genus	cytididae	valid
cytidmonea	Genus	cytididae	valid
cytis	Genus	cytididae	valid
dartevillea	Genus	cerioporidae	valid
decurrella	Genus	tubuliporidae	valid
defranciopora	Genus	cerioporidae	valid
dendroecia	Genus	cerioporidae	valid
densipora	Genus	densiporidae	valid
dentalitrypa	Genus	corynotrypidae	valid
desmatelesia	Genus	plagioeciidae	valid
desmediaperoecia	Genus	diaperoeciidae	valid
desmeplagioecia	Genus	diastoporidae	valid
diaperoecia	Genus	diaperoeciidae	valid
diaperoforma	Genus	uncertain	valid
diastopora	Genus	diastoporidae	valid
diastoporina	Genus	plagioeciidae	valid
diplocava	Genus	cerioporidae	valid
diploclema	Genus	diploclemidae	valid
diplodesmopora	Genus	cytididae	valid
diplopetalopora	Genus	crisinidae	valid
diplosolen	Genus	diastoporidae	valid
discocavea	Genus	lichenoporidae	valid
discocytis	Genus	cytididae	valid
discofascigera	Genus	frondiporidae	valid
discosparsa	Genus	uncertain	valid
discotruncatulipora	Genus	cytididae	valid
discotubigera	Genus	theonoidae	valid
disporella	Genus	lichenoporidae	valid
ditaxia	Genus	leiosoeciidae	valid
doliocoitis	Genus	lichenoporidae	valid
domopora	Genus	lichenoporidae	valid
echinocava	Genus	cytididae	valid
elea	Genus	eleidae	valid
entalophora	Genus	entalophoridae	valid
entalophoroecia	Genus	plagioeciidae	valid
eohornera	Genus	horneridae	valid
erkosonea	Genus	uncertain	valid
eurystrotos	Genus	diastoporidae	valid
exidmonea	Genus	tubuliporidae	valid
exochoecia	Genus	entalophoridae	valid
meandropora	Genus	frondiporidae	valid
fasciculipora	Genus	frondiporidae	valid
fasciculiporina	Genus	uncertain	valid
fascigera	Genus	frondiporidae	valid
fascipora	Genus	diastoporidae	valid
favosipora	Genus	densiporidae	valid
fenestulipora	Genus	tubuliporidae	valid
filicava	Genus	cerioporidae	valid
filicea	Genus	semiceidae	valid
filicisparsa	Genus	oncousoeciidae	valid
filicrisia	Genus	crisiidae	valid
filicrisina	Genus	terviidae	valid
filifascigera	Genus	frondiporidae	valid
filisparsa	Genus	filisparsidae	valid
flosculipora	Genus	densiporidae	valid
foliopora	Genus	filisparsidae	valid
foricula	Genus	eleidae	valid
frondipora	Genus	frondiporidae	valid
fungella	Genus	corymboporidae	valid
goryunovia	Genus	sagenellidae	valid
grammanatosoecia	Genus	petaloporidae	valid
grammascosoecia	Genus	petaloporidae	valid
harmelinopora	Genus	tubuliporidae	valid
hastingsia	Genus	hastingsiidae	valid
hemipustulopora	Genus	uncertain	valid
hemiseptopora	Genus	uncertain	valid
heterocrisina	Genus	cytididae	valid
heterohaplooecia	Genus	multisparsidae	valid
heteropora	Genus	heteroporidae	valid
homoeosolen	Genus	cytididae	valid
hornera	Genus	horneridae	valid
hypocytis	Genus	cytididae	valid
plagioecia	Genus	plagioeciidae	valid
idemonea	Genus	idmoneidae	valid
idmidronea	Genus	tubuliporidae	valid
idmonea	Genus	idmoneidae	valid
idmonella	Genus	tubuliporidae	valid
idmoneoides	Genus	uncertain	valid
infundibulipora	Genus	corymboporidae	valid
klugenotus	Genus	cerioporidae	valid
kololophos	Genus	theonoidae	valid
kukersella	Genus	crownoporidae	valid
kvarnbyella	Genus	siphoniotyphlidae	valid
lagenosypho	Genus	corynotrypidae	valid
lagonoecia	Genus	idmoneidae	valid
laterocea	Genus	semiceidae	valid
leiosoecia	Genus	leiosoeciidae	valid
lekythionia	Genus	plagioeciidae	valid
leptopora	Genus	oncousoeciidae	valid
liripora	Genus	diastoporidae	valid
lobomesenteripora	Genus	uncertain	valid
lobosoecia	Genus	lobosoeciidae	valid
locularia	Genus	theonoidae	valid
lopholepsis	Genus	theonoidae	valid
lunariopsis	Genus	uncertain	valid
marssoniella	Genus	cerioporidae	valid
mecynoecia	Genus	entalophoridae	valid
meliceritella	Genus	eleidae	valid
meliceritites	Genus	eleidae	valid
mesenteripora	Genus	plagioeciidae	valid
mesonea	Genus	crisinidae	valid
mesonopora	Genus	plagioeciidae	valid
metastomatopora	Genus	stomatoporidae	valid
microecia	Genus	diastoporidae	valid
microeciella	Genus	oncousoeciidae	valid
mitoclema	Genus	crownoporidae	valid
mitoclemina	Genus	crownoporidae	valid
multicavea	Genus	petaloporidae	valid
multicrescis	Genus	cerioporidae	valid
multifascigera	Genus	theonoidae	valid
multigalea	Genus	lichenoporidae	valid
multisparsa	Genus	multisparsidae	valid
nematifera	Genus	entalophoridae	valid
neofungella	Genus	cerioporidae	valid
neoretenoa	Genus	cytididae	valid
nevianipora	Genus	diaperoeciidae	valid
oncousoecia	Genus	oncousoeciidae	valid
osculipora	Genus	cytididae	valid
pachyteichopora	Genus	cerioporidae	valid
paleocrisidia	Genus	plagioeciidae	valid
paracrescis	Genus	lichenoporidae	valid
paratretocycloecia	Genus	cerioporidae	valid
lichenopora	Genus	lichenoporidae	valid
parleiosoecia	Genus	leiosoeciidae	valid
partretocycloecia	Genus	cerioporidae	valid
patenaria	Genus	lichenoporidae	valid
patinella	Genus	lichenoporidae	valid
patulopora	Genus	multisparsidae	valid
pavotubigera	Genus	theonoidae	valid
penciletta	Genus	oncousoeciidae	valid
pennipora	Genus	cerioporidae	valid
perfodiastopora	Genus	diastoporidae	valid
pergensella	Genus	tubuliporidae	valid
peripora	Genus	entalophoridae	valid
peristomatopora	Genus	stomatoporidae	valid
petalopora	Genus	petaloporidae	valid
phormopora	Genus	petaloporidae	valid
platonea	Genus	tubuliporidae	valid
plethopora	Genus	cytididae	valid
plethoporella	Genus	cytididae	valid
pleuronea	Genus	tubuliporidae	valid
polyascosoeciella	Genus	crisinidae	valid
poriceata	Genus	semiceidae	valid
poroplagioecia	Genus	plagioeciidae	valid
proboscina	Genus	oncousoeciidae	valid
proboscinopora	Genus	stomatoporidae	valid
prosthenoecia	Genus	uncertain	valid
pseudidmonea	Genus	pseudidmoneidae	valid
pseudoceriopora	Genus	pseudocerioporidae	valid
pseudocyrtopora	Genus	cytididae	valid
pseudofrondipora	Genus	frondiporidae	valid
pseudonevianopora	Genus	uncertain	valid
pseudotervia	Genus	terviidae	valid
psilosolen	Genus	cerioporidae	valid
pustulopora	Genus	pustuloporidae	valid
pyricavea	Genus	lichenoporidae	valid
radicipora	Genus	cerioporidae	valid
radiocavaria	Genus	lichenoporidae	valid
radiofascigera	Genus	theonoidae	valid
radiopora	Genus	lichenoporidae	valid
radiotubigera	Genus	theonoidae	valid
ramia	Genus	cerioporidae	valid
ramofilisparsa	Genus	uncertain	valid
reptoclausa	Genus	multisparsidae	valid
reptofascigera	Genus	tubuliporidae	valid
reptomultelea	Genus	eleidae	valid
reptomulticava	Genus	uncertain	valid
reptomulticlausa	Genus	cerioporidae	valid
reptomultisparsa	Genus	multisparsidae	valid
retecava	Genus	crisinidae	valid
retecavella	Genus	uncertain	valid
retelea	Genus	plagioeciidae	valid
retenoa	Genus	cytididae	valid
reteporidea	Genus	crisinidae	valid
reticrescis	Genus	cerioporidae	valid
reticrisina	Genus	plagioeciidae	valid
reticulipora	Genus	plagioeciidae	valid
rhipidopora	Genus	plagioeciidae	valid
ripisoecia	Genus	cerioporidae	valid
rodinopora	Genus	uncertain	valid
rosacilla	Genus	plagioeciidae	valid
sagenella	Genus	sagenellidae	valid
seguenziella	Genus	theonoidae	valid
semicea	Genus	semiceidae	valid
semicinctipora	Genus	cinctiporidae	valid
semicytella	Genus	cytididae	valid
semielea	Genus	eleidae	valid
semifascipora	Genus	plagioeciidae	valid
semifungella	Genus	corymboporidae	valid
semilaterotubigera	Genus	plagioeciidae	valid
semimulticavea	Genus	uncertain	valid
seminodicrescis	Genus	uncertain	valid
septocea	Genus	semiceidae	valid
serpentipora	Genus	diastoporidae	valid
silenopora	Genus	cerioporidae	valid
siphodictyum	Genus	horneridae	valid
siphoniotyphlus	Genus	siphoniotyphlidae	valid
sparsicavea	Genus	petaloporidae	valid
sparsicytis	Genus	cerioporidae	valid
spinihornera	Genus	horneridae	valid
spiritopora	Genus	diaperoeciidae	valid
spiropora	Genus	spiroporidae	valid
stathmepora	Genus	plagioeciidae	valid
stellihagenowia	Genus	lichenoporidae	valid
stellocavea	Genus	lichenoporidae	valid
stephanodesma	Genus	cytididae	valid
stigmatoechos	Genus	stigmatoechidae	valid
stomatopora	Genus	stomatoporidae	valid
stomatoporina	Genus	stomatoporidae	valid
stomatoporopsis	Genus	stomatoporidae	valid
sulcocava	Genus	semiceidae	valid
supercytis	Genus	cytididae	valid
talmontipora	Genus	uncertain	valid
tayloripora	Genus	tubuliporidae	valid
tecticavea	Genus	lichenoporidae	valid
telopora	Genus	cerioporidae	valid
tennysonia	Genus	tubuliporidae	valid
terebellaria	Genus	plagioeciidae	valid
tervia	Genus	terviidae	valid
tetragonoecia	Genus	uncertain	valid
tetrapora	Genus	multisparsidae	valid
tetrastomatopora	Genus	stomatoporidae	valid
tetrocycloecia	Genus	cerioporidae	valid
theonoa	Genus	theonoidae	valid
tholopora	Genus	uncertain	valid
tretonea	Genus	tubuliporidae	valid
triplozooecia	Genus	plagioeciidae	valid
trochiliopora	Genus	lichenoporidae	valid
truncatulipora	Genus	cytididae	valid
tubigera	Genus	plagioeciidae	valid
tubigerina	Genus	plagioeciidae	valid
tubulipora	Genus	tubuliporidae	valid
umbrellina	Genus	pustuloporidae	valid
unicavea	Genus	lichenoporidae	valid
unicrisia	Genus	crisiidae	valid
unicytis	Genus	cytididae	valid
unitubigera	Genus	theonoidae	valid
voigtia	Genus	crownoporidae	valid
voigticytis	Genus	cytididae	valid
voigtiellina	Genus	uncertain	valid
voigtopora	Genus	stomatoporidae	valid
wassypora	Genus	plagioeciidae	valid
wolinella	Genus	corynotrypidae	valid
ybselosoecia	Genus	diaperoeciidae	valid
zonopora	Genus	cerioporidae	valid
semicrescis	Genus	cerioporidae	valid
bryopesanser	Genus	escharinidae	valid
nigrapercula	Genus	bitectiporidae	valid
kermadecazoon	Genus	bitectiporidae	valid
costulostega	Genus	chorizoporidae	valid
calvipelta	Genus	celleporidae	valid
predanophora	Genus	celleporidae	valid
herentia	Genus	escharinidae	valid
callistopora	Genus	cribrilinidae	valid
amplexicamera	Genus	foveolariidae	valid
pourtalesella	Genus	celleporidae	valid
colatooecia	Genus	colatooeciidae	valid
hyporosopora	Genus	plagioeciidae	valid
aggregopora	Genus	uncertain	valid
laterocavea	Genus	petaloporidae	valid
anolotichiina	Genus	uncertain	valid
antonoclema	Genus	uncertain	valid
ceidmonea	Genus	uncertain	valid
claviradix	Genus	uncertain	valid
coeloclemis	Genus	uncertain	valid
eoheteropora	Genus	uncertain	valid
fasciculiporoides	Genus	uncertain	valid
feldmannia	Genus	uncertain	valid
filicavea	Genus	uncertain	valid
hyalotoechus	Genus	uncertain	valid
inconobotopora	Genus	uncertain	valid
jifarahpora	Genus	uncertain	valid
kanoshopora	Genus	uncertain	valid
lakkella	Genus	uncertain	valid
macgowanella	Genus	uncertain	valid
mackinneyella	Genus	uncertain	valid
maennilina	Genus	uncertain	valid
micropylepora	Genus	uncertain	valid
minutolunaria	Genus	uncertain	valid
nicholsonella	Genus	uncertain	valid
niigaella	Genus	uncertain	valid
omniretepora	Genus	uncertain	valid
palaeocoryne	Genus	uncertain	valid
paramaychella	Genus	uncertain	valid
petaloporella	Genus	uncertain	valid
phosphasipho	Genus	uncertain	valid
phosphotesta	Genus	uncertain	valid
phylloporinella	Genus	uncertain	valid
pileotrypella	Genus	uncertain	valid
pinnatopora	Genus	uncertain	valid
pinocladia	Genus	uncertain	valid
pseudobathyalozoon	Genus	uncertain	valid
ptilotrypa	Genus	uncertain	valid
ptilotrypina	Genus	uncertain	valid
radiotrypa	Genus	uncertain	valid
robinella	Genus	uncertain	valid
schallreuterella	Genus	uncertain	valid
schischcatella	Genus	uncertain	valid
schizotrema	Genus	uncertain	valid
spatiopora	Genus	uncertain	valid
spirella	Genus	uncertain	valid
spirentalophora	Genus	uncertain	valid
stereodictya	Genus	uncertain	valid
synocladiella	Genus	uncertain	valid
taeniodictya	Genus	uncertain	valid
tetratoechus	Genus	uncertain	valid
trepocryptopora	Genus	uncertain	valid
urnatella	Genus	uncertain	valid
varunella	Genus	uncertain	valid
mitoclemella	Genus	crownoporidae	valid
dacryopora	Genus	oncousoeciidae	valid
crisinella	Genus	tubuliporidae	valid
semitubigera	Genus	tubuliporidae	valid
phacelopora	Genus	phaceloporidae	valid
paraguataia	Genus	frondiporidae	valid
hemicellaria	Genus	petaloporidae	valid
jullienipora	Genus	stomatoporidae	valid
stoporatoma	Genus	stomatoporidae	valid
brestopora	Genus	crisinidae	valid
pergensia	Genus	entalophoridae	valid
acanthopora	Genus	cerioporidae	valid
buria	Genus	cerioporidae	valid
cyclocites	Genus	cerioporidae	valid
globulipora	Genus	cerioporidae	valid
spinopora	Genus	cerioporidae	valid
tretocycloecia	Genus	cerioporidae	valid
chilopora	Genus	leiosoeciidae	valid
monticulipora	Genus	cavidae	valid
actinotaxia	Genus	lichenoporidae	valid
paricavea	Genus	lichenoporidae	valid
radiocavea	Genus	lichenoporidae	valid
cystoporella	Genus	reptariidae	valid
hederopsis	Genus	reptariidae	valid
hernodia	Genus	reptariidae	valid
reptaria	Genus	reptariidae	valid
basslederella	Genus	hederellidae	valid
diversipora	Genus	hederellidae	valid
hederella	Genus	hederellidae	valid
magnederella	Genus	hederellidae	valid
paralhederella	Genus	hederellidae	valid
rhenanerella	Genus	hederellidae	valid
cephaloalcyonidium	Genus	clavoporidae	valid
pherusa	Genus	pherusellidae	valid
acanthodesia	Genus	membraniporidae	valid
filiflustrellaria	Genus	electridae	valid
reptoflustrina	Genus	electridae	valid
aviculamphiblestrum	Genus	calloporidae	valid
bonellina	Genus	calloporidae	valid
kristerina	Genus	calloporidae	valid
pseudoallantopora	Genus	calloporidae	valid
septentriopora	Genus	calloporidae	valid
clipeochaperia	Genus	chaperiidae	valid
semiescharellina	Genus	onychocellidae	valid
puncturiellina	Genus	metrarabdotosidae	valid
reussina	Genus	metrarabdotosidae	valid
discoescharites	Genus	lunulitidae	valid
escharinella	Genus	bryopastoridae	valid
cellariaeforma	Genus	cellariidae	valid
neocellariaeforma	Genus	cellariidae	valid
beanodendria	Genus	bugulidae	valid
thaminozoum	Genus	bugulidae	valid
amphibiobeania	Genus	beaniidae	valid
bugulicellaria	Genus	candidae	valid
retiscrupocellaria	Genus	candidae	valid
cribrilaria	Genus	cribrilinidae	valid
glabrilaria	Genus	cribrilinidae	valid
turnerellina	Genus	cribrilinidae	valid
antarctothoa	Genus	hippothoidae	valid
austrothoa	Genus	hippothoidae	valid
neothoa	Genus	hippothoidae	valid
oshurkovia	Genus	umbonulidae	valid
elleschara	Genus	romancheinidae	valid
perigastrella	Genus	romancheinidae	valid
biavicularium	Genus	metrarabdotosidae	valid
uniavicularium	Genus	metrarabdotosidae	valid
reptescharellina	Genus	lepraliellidae	valid
sinuporaria	Genus	lepraliellidae	valid
cribriporella	Genus	metrarabdotosidae	valid
patorporella	Genus	metrarabdotosidae	valid
multiporina	Genus	schizoporellidae	valid
junerossia	Genus	stomachetosellidae	valid
allorhynchozoon	Genus	phidoloporidae	valid
uniretepora	Genus	phidoloporidae	valid
simibryocryptella	Genus	bryocryptellidae	valid
sinuporina	Genus	celleporidae	valid
primavelans	Genus	pacificincolidae	valid
cureolipora	Genus	uncertain	valid
peedeesella	Genus	peedeesellidae	valid
acorania	Genus	acoraniidae	valid
basslerinella	Genus	chiplonkarinidae	valid
sfeniella	Genus	sfeniellidae	valid
stephanollina	Genus	sfeniellidae	valid
amalgamoporus	Genus	rhinidictyidae	valid
athrophragma	Genus	rhinidictyidae	valid
carinodictya	Genus	rhinidictyidae	valid
cricodictyum	Genus	rhinidictyidae	valid
cystostictoporus	Genus	rhinidictyidae	valid
eopachydictya	Genus	rhinidictyidae	valid
eurydictya	Genus	rhinidictyidae	valid
euspilopora	Genus	rhinidictyidae	valid
goniotrypa	Genus	rhinidictyidae	valid
junggarotrypa	Genus	rhinidictyidae	valid
metadictya	Genus	rhinidictyidae	valid
orectodictya	Genus	rhinidictyidae	valid
pachydictya	Genus	rhinidictyidae	valid
phyllodictya	Genus	rhinidictyidae	valid
prophyllodictya	Genus	rhinidictyidae	valid
rhinidictya	Genus	rhinidictyidae	valid
sibiredictya	Genus	rhinidictyidae	valid
stictopora	Genus	rhinidictyidae	valid
stictotrypa	Genus	rhinidictyidae	valid
trigonodictya	Genus	rhinidictyidae	valid
amurodictya	Genus	stictoporellidae	valid
astrovidictya	Genus	stictoporellidae	valid
heliotrypa	Genus	stictoporellidae	valid
pseudostictoporella	Genus	stictoporellidae	valid
stictoporella	Genus	stictoporellidae	valid
stictoporellina	Genus	stictoporellidae	valid
pseudopachydictya	Genus	chiplonkarinidae	valid
virgatella	Genus	chiplonkarinidae	valid
championodictya	Genus	escharoporidae	valid
chazydictya	Genus	escharoporidae	valid
eoescharopora	Genus	escharoporidae	valid
escharopora	Genus	escharoporidae	valid
graptodictya	Genus	escharoporidae	valid
oanduella	Genus	escharoporidae	valid
oanduellina	Genus	escharoporidae	valid
proavella	Genus	escharoporidae	valid
cladodictya	Genus	ptilodictyidae	valid
clathropora	Genus	ptilodictyidae	valid
ensiphragma	Genus	ptilodictyidae	valid
ensipora	Genus	ptilodictyidae	valid
insignia	Genus	ptilodictyidae	valid
phaenophragma	Genus	ptilodictyidae	valid
phaenoporella	Genus	ptilodictyidae	valid
pteropora	Genus	ptilodictyidae	valid
ptilodictya	Genus	ptilodictyidae	valid
stellatodictya	Genus	ptilodictyidae	valid
coscinella	Genus	intraporidae	valid
intrapora	Genus	intraporidae	valid
goldfussitrypa	Genus	goldfussitrypidae	valid
nemacanthoclema	Genus	goldfussitrypidae	valid
nemacanthopora	Genus	goldfussitrypidae	valid
paranicklesopora	Genus	goldfussitrypidae	valid
veroclema	Genus	goldfussitrypidae	valid
maychella	Genus	maychellidae	valid
crockfordia	Genus	maychellinidae	valid
maychellina	Genus	maychellinidae	valid
ipmorella	Genus	streblascoporidae	valid
ogbinopora	Genus	streblascoporidae	valid
streblascopora	Genus	streblascoporidae	valid
eichwaldictya	Genus	phaenoporidae	valid
phaenopora	Genus	phaenoporidae	valid
paleschara	Genus	palescharidae	valid
arthroclema	Genus	nematoporidae	valid
heloclema	Genus	nematoporidae	valid
hexites	Genus	nematoporidae	valid
nematopora	Genus	nematoporidae	valid
ottoseetaxis	Genus	nematoporidae	valid
permoheloclema	Genus	nematoporidae	valid
primorella	Genus	nematoporidae	valid
clausotrypa	Genus	nematotrypidae	valid
kielanopora	Genus	nematotrypidae	valid
moyerella	Genus	nematotrypidae	valid
nematotrypa	Genus	nematotrypidae	valid
arcanopora	Genus	arthrostylidae	valid
arthrostyloecia	Genus	arthrostylidae	valid
arthrostylus	Genus	arthrostylidae	valid
arthrotrypa	Genus	arthrostylidae	valid
cuneatopora	Genus	arthrostylidae	valid
cyclophaenopora	Genus	arthrostylidae	valid
heminematopora	Genus	arthrostylidae	valid
hemiulrichostylus	Genus	arthrostylidae	valid
osburnostylus	Genus	arthrostylidae	valid
pseudonematopora	Genus	arthrostylidae	valid
sceptropora	Genus	arthrostylidae	valid
tropidopora	Genus	arthrostylidae	valid
ulrichostylus	Genus	arthrostylidae	valid
acanthoclema	Genus	hyphasmoporidae	valid
ascoporella	Genus	hyphasmoporidae	valid
helopora	Genus	hyphasmoporidae	valid
hyphasmopora	Genus	hyphasmoporidae	valid
matsutrypa	Genus	hyphasmoporidae	valid
mongoloclema	Genus	hyphasmoporidae	valid
neorhombopora	Genus	hyphasmoporidae	valid
rozanovia	Genus	hyphasmoporidae	valid
streblotrypa	Genus	hyphasmoporidae	valid
klaucena	Genus	rhomboporidae	valid
megacanthoporina	Genus	rhomboporidae	valid
orthopora	Genus	rhomboporidae	valid
pamirella	Genus	rhomboporidae	valid
pictatella	Genus	rhomboporidae	valid
rhombopora	Genus	rhomboporidae	valid
saffordotaxis	Genus	rhomboporidae	valid
shishoviclema	Genus	rhomboporidae	valid
spira	Genus	rhomboporidae	valid
artchedella	Genus	nikiforovellidae	valid
nikiforovella	Genus	nikiforovellidae	valid
pinegopora	Genus	nikiforovellidae	valid
streblotrypella	Genus	nikiforovellidae	valid
tebitopora	Genus	nikiforovellidae	valid
archaeomeson	Genus	rhabdomesidae	valid
ascopora	Genus	rhabdomesidae	valid
bigeyella	Genus	rhabdomesidae	valid
coelotubulipora	Genus	rhabdomesidae	valid
denmeadopora	Genus	rhabdomesidae	valid
euthyrhombopora	Genus	rhabdomesidae	valid
lutulentus	Genus	rhabdomesidae	valid
mediaporina	Genus	rhabdomesidae	valid
megacanthopora	Genus	rhabdomesidae	valid
nemataxidra	Genus	rhabdomesidae	valid
nemataxis	Genus	rhabdomesidae	valid
promediapora	Genus	rhabdomesidae	valid
pseudorhabdomeson	Genus	rhabdomesidae	valid
rhabdomeson	Genus	rhabdomesidae	valid
rhomboporella	Genus	rhabdomesidae	valid
spirillopora	Genus	rhabdomesidae	valid
streblocladia	Genus	rhabdomesidae	valid
strebloplax	Genus	rhabdomesidae	valid
trematella	Genus	rhabdomesidae	valid
uralotrypa	Genus	rhabdomesidae	valid
bactropora	Genus	bactroporidae	valid
phragmophera	Genus	phragmopheridae	valid
nudymiella	Genus	nudymiellidae	valid
tamaroclema	Genus	tamaroclemidae	valid
mediapora	Genus	mediaporidae	valid
pseudoascopora	Genus	pseudoascoporidae	valid
silenella	Genus	pseudoascoporidae	valid
chasmatoporella	Genus	arcanoporidae	valid
pesnastylus	Genus	arcanoporidae	valid
europora	Genus	nicklesoporidae	valid
nicklesopora	Genus	nicklesoporidae	valid
flabellotrypa	Genus	flabellotrypidae	valid
mojczatrypa	Genus	flabellotrypidae	valid
kielcepora	Genus	kielceporidae	valid
ojlepora	Genus	kielceporidae	valid
ralfinella	Genus	kielceporidae	valid
bajoola	Genus	semicosciniidae	valid
cyclopelta	Genus	semicosciniidae	valid
eosemicoscinium	Genus	semicosciniidae	valid
ignotrypa	Genus	semicosciniidae	valid
ikelarchimedes	Genus	semicosciniidae	valid
isotrypa	Genus	semicosciniidae	valid
loculipora	Genus	semicosciniidae	valid
medisemicoscinium	Genus	semicosciniidae	valid
neoreteporina	Genus	semicosciniidae	valid
praesemicoscinium	Genus	semicosciniidae	valid
pseudounitrypa	Genus	semicosciniidae	valid
quadrisemicoscinium	Genus	semicosciniidae	valid
reteporina	Genus	semicosciniidae	valid
schischkatella	Genus	semicosciniidae	valid
semicoscinium	Genus	semicosciniidae	valid
semifenestella	Genus	semicosciniidae	valid
speotrypa	Genus	semicosciniidae	valid
unitrypa	Genus	semicosciniidae	valid
viscovia	Genus	semicosciniidae	valid
aequifenestella	Genus	fenestellidae	valid
alternifenestella	Genus	fenestellidae	valid
anastomopora	Genus	fenestellidae	valid
apertostella	Genus	fenestellidae	valid
archaeofenestella	Genus	fenestellidae	valid
archimedes	Genus	fenestellidae	valid
australofenestella	Genus	fenestellidae	valid
australopolypora	Genus	fenestellidae	valid
banastella	Genus	fenestellidae	valid
biarmiella	Genus	fenestellidae	valid
bicorbis	Genus	fenestellidae	valid
cubifenestella	Genus	fenestellidae	valid
dictyoretmon	Genus	fenestellidae	valid
exfenestella	Genus	fenestellidae	valid
fabifenestella	Genus	fenestellidae	valid
fenestella	Genus	fenestellidae	valid
fenestellata	Genus	fenestellidae	valid
fenestepora	Genus	fenestellidae	valid
fenesteverta	Genus	fenestellidae	valid
filites	Genus	fenestellidae	valid
flexifenestella	Genus	fenestellidae	valid
helicopora	Genus	fenestellidae	valid
hemitrypa	Genus	fenestellidae	valid
hemitrypella	Genus	fenestellidae	valid
hinganotrypa	Genus	fenestellidae	valid
ispanayella	Genus	fenestellidae	valid
kazarchimedes	Genus	fenestellidae	valid
kingopora	Genus	fenestellidae	valid
laxifenestella	Genus	fenestellidae	valid
lunofenestella	Genus	fenestellidae	valid
lyrocladia	Genus	fenestellidae	valid
lyropora	Genus	fenestellidae	valid
lyroporidra	Genus	fenestellidae	valid
mirandifenestella	Genus	fenestellidae	valid
moorephylloporina	Genus	fenestellidae	valid
narynella	Genus	fenestellidae	valid
nebrodensia	Genus	fenestellidae	valid
neohemitrypa	Genus	fenestellidae	valid
neopolypora	Genus	fenestellidae	valid
ogbinofenestella	Genus	fenestellidae	valid
parapolypora	Genus	fenestellidae	valid
paraptylopora	Genus	fenestellidae	valid
paraseptopora	Genus	fenestellidae	valid
patellipora	Genus	fenestellidae	valid
paucipora	Genus	fenestellidae	valid
polycladiopora	Genus	fenestellidae	valid
polyporella	Genus	fenestellidae	valid
polyporellina	Genus	fenestellidae	valid
protoretepora	Genus	fenestellidae	valid
pseudoisotrypa	Genus	fenestellidae	valid
pseudopolypora	Genus	fenestellidae	valid
ptilofenestella	Genus	fenestellidae	valid
ptilopora	Genus	fenestellidae	valid
ptiloporella	Genus	fenestellidae	valid
pustuloporina	Genus	fenestellidae	valid
rectifenestella	Genus	fenestellidae	valid
reteporidra	Genus	fenestellidae	valid
rhombofenestella	Genus	fenestellidae	valid
rugofenestella	Genus	fenestellidae	valid
ryhopora	Genus	fenestellidae	valid
shulgapora	Genus	fenestellidae	valid
sphragiopora	Genus	fenestellidae	valid
spinofenestella	Genus	fenestellidae	valid
utropora	Genus	fenestellidae	valid
wjatkella	Genus	fenestellidae	valid
aluverina	Genus	phylloporinidae	valid
alwynopora	Genus	phylloporinidae	valid
austraphylloporina	Genus	phylloporinidae	valid
bashkirella	Genus	phylloporinidae	valid
carinophylloporina	Genus	phylloporinidae	valid
chasmatopora	Genus	phylloporinidae	valid
esthonioporina	Genus	phylloporinidae	valid
hemibashkirella	Genus	phylloporinidae	valid
kallodictyon	Genus	phylloporinidae	valid
oeciophylloporina	Genus	phylloporinidae	valid
parachasmatopora	Genus	phylloporinidae	valid
phylloporina	Genus	phylloporinidae	valid
pinnatoporella	Genus	phylloporinidae	valid
polipora	Genus	phylloporinidae	valid
pseudohornera	Genus	phylloporinidae	valid
rhombocladia	Genus	phylloporinidae	valid
subretepora	Genus	phylloporinidae	valid
trepostomina	Genus	phylloporinidae	valid
acanthocladia	Genus	acanthocladiidae	valid
arborocladia	Genus	acanthocladiidae	valid
baculopora	Genus	acanthocladiidae	valid
diploporaria	Genus	acanthocladiidae	valid
eulyra	Genus	acanthocladiidae	valid
ichthyorachis	Genus	acanthocladiidae	valid
kalvariella	Genus	acanthocladiidae	valid
penniretepora	Genus	acanthocladiidae	valid
ptiloporina	Genus	acanthocladiidae	valid
samaria	Genus	acanthocladiidae	valid
synocladiopsis	Genus	acanthocladiidae	valid
thamniscus	Genus	acanthocladiidae	valid
parafenestralia	Genus	fenestraliidae	valid
triznella	Genus	fenestraliidae	valid
septatopora	Genus	septatoporidae	valid
matheropora	Genus	septoporidae	valid
pseudoseptopora	Genus	septoporidae	valid
septopora	Genus	septoporidae	valid
silvaseptopora	Genus	septoporidae	valid
synocladia	Genus	septoporidae	valid
chasmatoporina	Genus	enalloporidae	valid
conphylloporina	Genus	enalloporidae	valid
enallopora	Genus	enalloporidae	valid
pushkinella	Genus	enalloporidae	valid
ralfina	Genus	ralfinidae	valid
sardesonina	Genus	sardesoninidae	valid
chainodictyon	Genus	chainodictyonidae	valid
admiranda	Genus	admiratellidae	valid
admiratella	Genus	admiratellidae	valid
rarifenestella	Genus	admiratellidae	valid
trataucladia	Genus	admiratellidae	valid
fenestralia	Genus	polyporidae	valid
polypora	Genus	polyporidae	valid
carnocladia	Genus	carnocladiidae	valid
aviculofenestella	Genus	fenestraporidae	valid
cavernella	Genus	fenestraporidae	valid
fenestrapora	Genus	fenestraporidae	valid
ignotifenestella	Genus	fenestraporidae	valid
mirifenestella	Genus	fenestraporidae	valid
permofenestella	Genus	fenestraporidae	valid
polyfenestella	Genus	fenestraporidae	valid
esthoniopora	Genus	esthonioporidae	valid
esthonioporella	Genus	esthonioporidae	valid
chondraulus	Genus	orbiporidae	valid
ibexella	Genus	orbiporidae	valid
nekhorosheviella	Genus	orbiporidae	valid
orbipora	Genus	orbiporidae	valid
balticoporella	Genus	dittoporidae	valid
dittopora	Genus	dittoporidae	valid
hemiphragma	Genus	dittoporidae	valid
phragmopora	Genus	dittoporidae	valid
phragmoporella	Genus	dittoporidae	valid
polyteichus	Genus	dittoporidae	valid
stromatotrypa	Genus	dittoporidae	valid
dekayia	Genus	heterotrypidae	valid
eichwaldopora	Genus	heterotrypidae	valid
heterotrypa	Genus	heterotrypidae	valid
jordanopora	Genus	heterotrypidae	valid
pedrogopora	Genus	heterotrypidae	valid
petigopora	Genus	heterotrypidae	valid
phragmotrypa	Genus	heterotrypidae	valid
reptonoditrypa	Genus	heterotrypidae	valid
stigmatella	Genus	heterotrypidae	valid
hinaclema	Genus	leioclemidae	valid
leioclema	Genus	leioclemidae	valid
leioclemina	Genus	leioclemidae	valid
lioclemella	Genus	leioclemidae	valid
paralioclema	Genus	leioclemidae	valid
permoleioclema	Genus	leioclemidae	valid
calloporella	Genus	halloporidae	valid
hallopora	Genus	halloporidae	valid
panderpora	Genus	halloporidae	valid
parvohallopora	Genus	halloporidae	valid
tarphophragma	Genus	halloporidae	valid
abakana	Genus	trematoporidae	valid
acanthotrypa	Genus	trematoporidae	valid
aostipora	Genus	trematoporidae	valid
armillopora	Genus	trematoporidae	valid
balticopora	Genus	trematoporidae	valid
batostoma	Genus	trematoporidae	valid
calamotrypa	Genus	trematoporidae	valid
diatrypella	Genus	trematoporidae	valid
minussina	Genus	trematoporidae	valid
neotrematopora	Genus	trematoporidae	valid
trematopora	Genus	trematoporidae	valid
trematoporina	Genus	trematoporidae	valid
acantholaminatus	Genus	monticuliporidae	valid
aspidopora	Genus	monticuliporidae	valid
gortanipora	Genus	monticuliporidae	valid
atactoporella	Genus	mesotrypidae	valid
diazipora	Genus	mesotrypidae	valid
homotrypa	Genus	mesotrypidae	valid
mesopora	Genus	mesotrypidae	valid
mesotrypa	Genus	mesotrypidae	valid
peronopora	Genus	mesotrypidae	valid
prasopora	Genus	mesotrypidae	valid
prasoporina	Genus	mesotrypidae	valid
roemeripora	Genus	mesotrypidae	valid
acanthotrypina	Genus	amplexoporidae	valid
amplexopora	Genus	amplexoporidae	valid
amplexoporella	Genus	amplexoporidae	valid
anaphragma	Genus	amplexoporidae	valid
discotrypa	Genus	amplexoporidae	valid
discotrypina	Genus	amplexoporidae	valid
halloporina	Genus	amplexoporidae	valid
monotrypa	Genus	amplexoporidae	valid
monotrypella	Genus	amplexoporidae	valid
rhombotrypa	Genus	amplexoporidae	valid
triznotrypa	Genus	amplexoporidae	valid
anomalotoechus	Genus	atactotoechidae	valid
atactopora	Genus	atactotoechidae	valid
atactotoechus	Genus	atactotoechidae	valid
cyphotrypa	Genus	atactotoechidae	valid
leptotrypa	Genus	atactotoechidae	valid
leptotrypella	Genus	atactotoechidae	valid
loxophragma	Genus	atactotoechidae	valid
multiphragma	Genus	atactotoechidae	valid
orbignyella	Genus	atactotoechidae	valid
paratrachytoechus	Genus	atactotoechidae	valid
polyspinopora	Genus	atactotoechidae	valid
pycnobasis	Genus	atactotoechidae	valid
schulgina	Genus	atactotoechidae	valid
sinoatactotoechus	Genus	atactotoechidae	valid
triplopora	Genus	atactotoechidae	valid
eostenopora	Genus	eridotrypellidae	valid
eridocampylus	Genus	eridotrypellidae	valid
eridotrypella	Genus	eridotrypellidae	valid
eridotrypellina	Genus	eridotrypellidae	valid
hinganella	Genus	eridotrypellidae	valid
idioclema	Genus	eridotrypellidae	valid
kysylschinipora	Genus	eridotrypellidae	valid
microcampylus	Genus	eridotrypellidae	valid
neoeridocampylus	Genus	eridotrypellidae	valid
neoeridotrypella	Genus	eridotrypellidae	valid
permopora	Genus	eridotrypellidae	valid
stenocladia	Genus	eridotrypellidae	valid
trachytoechus	Genus	eridotrypellidae	valid
anisotrypa	Genus	anisotrypidae	valid
anisotrypella	Genus	anisotrypidae	valid
boardmanella	Genus	anisotrypidae	valid
diplostenopora	Genus	anisotrypidae	valid
callocladia	Genus	crustoporidae	valid
crustopora	Genus	crustoporidae	valid
crustoporella	Genus	crustoporidae	valid
dunayeva	Genus	crustoporidae	valid
hunanopora	Genus	crustoporidae	valid
leeporina	Genus	crustoporidae	valid
lioporidra	Genus	crustoporidae	valid
metelipora	Genus	crustoporidae	valid
tabuliporella	Genus	crustoporidae	valid
arcticopora	Genus	dyscritellidae	valid
dyscritella	Genus	dyscritellidae	valid
dyscritellina	Genus	dyscritellidae	valid
dyscritellopsis	Genus	dyscritellidae	valid
eodyscritella	Genus	dyscritellidae	valid
pseudobatostomella	Genus	dyscritellidae	valid
stellahexaformis	Genus	dyscritellidae	valid
asperopora	Genus	stenoporidae	valid
diaphragmopora	Genus	stenoporidae	valid
dyoidophragma	Genus	stenoporidae	valid
fitzroyopora	Genus	stenoporidae	valid
flabellirete	Genus	stenoporidae	valid
granivallum	Genus	stenoporidae	valid
nikiforopora	Genus	stenoporidae	valid
parastenodiscus	Genus	stenoporidae	valid
percyopora	Genus	stenoporidae	valid
pycnopora	Genus	stenoporidae	valid
qilianopora	Genus	stenoporidae	valid
rhombotrypella	Genus	stenoporidae	valid
stenodiscus	Genus	stenoporidae	valid
stenophragmidium	Genus	stenoporidae	valid
stenopora	Genus	stenoporidae	valid
tabulipora	Genus	stenoporidae	valid
petalotrypa	Genus	ulrichotrypellidae	valid
ulrichotrypa	Genus	ulrichotrypellidae	valid
ulrichotrypella	Genus	ulrichotrypellidae	valid
bimuropora	Genus	bimuroporidae	valid
champlainopora	Genus	bimuroporidae	valid
sonninopora	Genus	bimuroporidae	valid
aisenvergia	Genus	aisenvergiidae	valid
eridotrypa	Genus	aisenvergiidae	valid
lamottopora	Genus	aisenvergiidae	valid
newportopora	Genus	aisenvergiidae	valid
orbiramus	Genus	aisenvergiidae	valid
polycylindricus	Genus	aisenvergiidae	valid
volnovachia	Genus	aisenvergiidae	valid
astroviella	Genus	hemieridotrypidae	valid
astroviellina	Genus	hemieridotrypidae	valid
hemieridotrypa	Genus	hemieridotrypidae	valid
gilmouropora	Genus	girtyporidae	valid
girtypora	Genus	girtyporidae	valid
girtyporina	Genus	girtyporidae	valid
hayasakapora	Genus	girtyporidae	valid
morozovapora	Genus	girtyporidae	valid
morozoviella	Genus	girtyporidae	valid
syringoclemis	Genus	girtyporidae	valid
tavayzopora	Genus	girtyporidae	valid
iraidina	Genus	stenoporellidae	valid
stenoporella	Genus	stenoporellidae	valid
cyclopora	Genus	cycloporidae	valid
cycloporella	Genus	cycloporidae	valid
proutella	Genus	cycloporidae	valid
araxopora	Genus	araxoporidae	valid
ruzhencevia	Genus	araxoporidae	valid
styloclema	Genus	araxoporidae	valid
astralochoma	Genus	astralochomidae	valid
helenopora	Genus	helenoporidae	valid
diplotrypa	Genus	diplotrypidae	valid
dianulites	Genus	dianulitidae	valid
nipponostenopora	Genus	nipponostenoporidae	valid
yunnanopora	Genus	nipponostenoporidae	valid
vysokella	Genus	zozariellidae	valid
zozariella	Genus	zozariellidae	valid
batostomella	Genus	batostomellidae	valid
batostomellina	Genus	batostomellidae	valid
bythopora	Genus	batostomellidae	valid
callotrypa	Genus	batostomellidae	valid
calacanthopora	Genus	stereotoechidae	valid
stereotoechus	Genus	stereotoechidae	valid
pseudocampylus	Genus	pseudocampylidae	valid
bodywskites	Genus	ralfimartitidae	valid
dybowskites	Genus	ralfimartitidae	valid
nolvakites	Genus	ralfimartitidae	valid
ralfimartites	Genus	ralfimartitidae	valid
rozhnovites	Genus	ralfimartitidae	valid
mishulgella	Genus	mishulgellidae	valid
hennigopora	Genus	xenotrypidae	valid
xenotrypa	Genus	xenotrypidae	valid
altshedata	Genus	anolotichiidae	valid
anolotichia	Genus	anolotichiidae	valid
archaeotrypa	Genus	anolotichiidae	valid
bythotrypa	Genus	anolotichiidae	valid
crassaluna	Genus	anolotichiidae	valid
lamtshinopora	Genus	anolotichiidae	valid
podljassipora	Genus	anolotichiidae	valid
profistulipora	Genus	anolotichiidae	valid
scenellopora	Genus	anolotichiidae	valid
constellaria	Genus	constellariidae	valid
idiotrypa	Genus	constellariidae	valid
lunaferamita	Genus	constellariidae	valid
revalopora	Genus	constellariidae	valid
stellipora	Genus	constellariidae	valid
lichenalia	Genus	rhinoporidae	valid
rhinopora	Genus	rhinoporidae	valid
rhinoporella	Genus	rhinoporidae	valid
buskopora	Genus	fistuliporidae	valid
canutrypa	Genus	fistuliporidae	valid
cassianopora	Genus	fistuliporidae	valid
cheilotrypa	Genus	fistuliporidae	valid
cliocystiramus	Genus	fistuliporidae	valid
cliotrypa	Genus	fistuliporidae	valid
coelocaulis	Genus	fistuliporidae	valid
cyclotrypa	Genus	fistuliporidae	valid
cystiramus	Genus	fistuliporidae	valid
cystitrypa	Genus	fistuliporidae	valid
diamesopora	Genus	fistuliporidae	valid
discotrypella	Genus	fistuliporidae	valid
duncanoclema	Genus	fistuliporidae	valid
dybowskiella	Genus	fistuliporidae	valid
eofistulotrypa	Genus	fistuliporidae	valid
eridopora	Genus	fistuliporidae	valid
favicella	Genus	fistuliporidae	valid
fistulacanta	Genus	fistuliporidae	valid
fistuliphragma	Genus	fistuliporidae	valid
fistuliphragmoides	Genus	fistuliporidae	valid
fistulipora	Genus	fistuliporidae	valid
fistuliporella	Genus	fistuliporidae	valid
fistuliporidra	Genus	fistuliporidae	valid
fistuliramus	Genus	fistuliporidae	valid
fistulocladia	Genus	fistuliporidae	valid
fistulotrypa	Genus	fistuliporidae	valid
kasakhstanella	Genus	fistuliporidae	valid
lichenotrypa	Genus	fistuliporidae	valid
odontotrypa	Genus	fistuliporidae	valid
parametelipora	Genus	fistuliporidae	valid
pholidopora	Genus	fistuliporidae	valid
pileotrypa	Genus	fistuliporidae	valid
pinacotrypa	Genus	fistuliporidae	valid
realeksella	Genus	fistuliporidae	valid
selenopora	Genus	fistuliporidae	valid
strotopora	Genus	fistuliporidae	valid
ceramella	Genus	hexagonellidae	valid
coscinium	Genus	hexagonellidae	valid
coscinotrypa	Genus	hexagonellidae	valid
evactinopora	Genus	hexagonellidae	valid
evactinostella	Genus	hexagonellidae	valid
fistulamina	Genus	hexagonellidae	valid
galtopora	Genus	hexagonellidae	valid
glyptopora	Genus	hexagonellidae	valid
hexagonella	Genus	hexagonellidae	valid
meekopora	Genus	hexagonellidae	valid
meekoporella	Genus	hexagonellidae	valid
pakrydictya	Genus	hexagonellidae	valid
phractopora	Genus	hexagonellidae	valid
prismopora	Genus	hexagonellidae	valid
scalaripora	Genus	hexagonellidae	valid
volgia	Genus	hexagonellidae	valid
botryllopora	Genus	botrylloporidae	valid
acrogenia	Genus	cystodictyonidae	valid
cystodictya	Genus	cystodictyonidae	valid
dichotrypa	Genus	cystodictyonidae	valid
filiramoporina	Genus	cystodictyonidae	valid
lophoclema	Genus	cystodictyonidae	valid
mongolodictya	Genus	cystodictyonidae	valid
ptilocella	Genus	cystodictyonidae	valid
semiopora	Genus	cystodictyonidae	valid
stictocella	Genus	cystodictyonidae	valid
sulcoretepora	Genus	cystodictyonidae	valid
taeniopora	Genus	cystodictyonidae	valid
thamnotrypa	Genus	cystodictyonidae	valid
amsassipora	Genus	ceramoporidae	valid
belorussipora	Genus	ceramoporidae	valid
ceramophylla	Genus	ceramoporidae	valid
ceramopora	Genus	ceramoporidae	valid
ceramoporella	Genus	ceramoporidae	valid
crepipora	Genus	ceramoporidae	valid
favositella	Genus	ceramoporidae	valid
ganiella	Genus	ceramoporidae	valid
haplotrypa	Genus	ceramoporidae	valid
isphairamella	Genus	ceramoporidae	valid
papillalunaria	Genus	ceramoporidae	valid
vasalemmapora	Genus	ceramoporidae	valid
actinotrypa	Genus	actinotrypidae	valid
actinotrypella	Genus	actinotrypidae	valid
epiactinotrypa	Genus	actinotrypidae	valid
aetomacladia	Genus	goniocladiidae	valid
cystocladia	Genus	goniocladiidae	valid
goniocladia	Genus	goniocladiidae	valid
ramipora	Genus	goniocladiidae	valid
ramiporalia	Genus	goniocladiidae	valid
ramiporella	Genus	goniocladiidae	valid
etherella	Genus	etherellidae	valid
liguloclema	Genus	etherellidae	valid
revalotrypa	Genus	revalotrypidae	valid
acanthoceramoporella	Genus	acanthoceramoporellidae	valid
sakagamiina	Genus	timanodictyidae	valid
timanodictya	Genus	timanodictyidae	valid
timanotrypa	Genus	timanodictyidae	valid
uldzapora	Genus	timanodictyidae	valid
worthenopora	Genus	worthenoporidae	valid
murengoloclema	Genus	murengoloclemidae	valid
cristatella	Genus	cristatellidae	valid
asajirella	Genus	lophopodidae	valid
lophopodella	Genus	lophopodidae	valid
lophopus	Genus	lophopodidae	valid
fredericella	Genus	fredericellidae	valid
afrindella	Genus	plumatellidae	valid
gelatinella	Genus	plumatellidae	valid
hyalinella	Genus	plumatellidae	valid
internectella	Genus	plumatellidae	valid
plumatella	Genus	plumatellidae	valid
stephanella	Genus	plumatellidae	valid
stolella	Genus	plumatellidae	valid
swarupella	Genus	plumatellidae	valid
pectinatella	Genus	pectinatellidae	valid
compressocoenites	Genus	uncertain	valid
vidronovella	Genus	vidronovellidae	valid
